-,-,-,-,-,-,-,-,-,-,-,-,-,-,-,-,-,-,-,-,-,-,-,-,-,-,-,-,-,-,-,-,-,-,-,-,-,-,-,-,-,-,-,-,-,-,-,-,-,-,-,-,-,-,-,-,-,-,-,-,-,-,-,-,-,-,-,-,-,-,-,-,-,-,-,-,-,-,-,-,-,-,-,-,-,-,-,-,-,-,-,-,-,-,-,-
-,-,-,-,↓,↓,↑,↑,-,-,-,-,-,-,-,-,-,-,-,-,-,-,-,-,-,-,-,-,-,-,-,↓,↓,↑,↑,-,-,-,-,-,-,-,-,-,-,-,-,-,-,-,-,-,-,-,-,-,-,-,-,-,-,-,-,-,-,-,-,-,-,-,-,-,-,-,-,-,-,-,-,-,-,-,-,-,-,-,-,-,↓,↓,↑,↑,-,-,-,-
-,-,-,-,↓,↓,↑,↑,-,-,-,-,-,-,-,-,-,-,-,-,-,-,-,-,-,-,-,-,-,-,-,↓,↓,↑,↑,-,-,-,-,-,-,-,-,-,-,-,-,-,-,-,-,-,-,-,-,-,-,-,-,-,-,-,-,-,-,-,-,-,-,-,-,-,-,-,-,-,-,-,-,-,-,-,-,-,-,-,-,-,↓,↓,↑,↑,-,-,-,-
-,-,-,-,⇣,⇣,↑,↑,-,-,-,-,-,-,-,-,-,-,-,-,-,-,-,-,-,-,-,-,-,-,-,⇣,⇣,↑,↑,-,-,-,-,-,-,-,-,-,-,-,-,-,-,-,-,-,-,-,-,-,-,-,-,-,-,-,-,-,-,-,-,-,-,-,-,-,-,-,-,-,-,-,-,-,-,-,-,-,-,-,-,-,⇣,⇣,↑,↑,-,-,-,-
-,←,←,←,+,+,+,+,⇠,←,←,←,←,←,←,←,←,←,←,←,←,←,←,←,←,←,←,←,←,←,←,+,+,+,+,⇠,←,←,←,←,←,←,←,←,←,←,←,←,←,←,←,←,←,←,←,←,←,←,←,←,←,←,←,←,←,←,←,←,←,←,←,←,←,←,←,←,←,←,←,←,←,←,←,←,←,←,←,←,+,+,+,+,⇠,←,←,-
-,←,←,←,+,+,+,+,⇠,←,←,←,←,←,←,←,←,←,←,←,←,←,←,←,←,←,←,←,←,←,←,+,+,+,+,⇠,←,←,←,←,←,←,←,←,←,←,←,←,←,←,←,←,←,←,←,←,←,←,←,←,←,←,←,←,←,←,←,←,←,←,←,←,←,←,←,←,←,←,←,←,←,←,←,←,←,←,←,←,+,+,+,+,⇠,←,←,-
-,→,→,⇢,+,+,+,+,→,→,→,→,→,→,→,→,→,→,→,→,→,→,→,→,→,→,→,→,→,→,⇢,+,+,+,+,→,→,→,→,→,→,→,→,→,→,→,→,→,→,→,→,→,→,→,→,→,→,→,→,→,→,→,→,→,→,→,→,→,→,→,→,→,→,→,→,→,→,→,→,→,→,→,→,→,→,→,→,⇢,+,+,+,+,→,→,→,-
-,→,→,⇢,+,+,+,+,→,→,→,→,→,→,→,→,→,→,→,→,→,→,→,→,→,→,→,→,→,→,⇢,+,+,+,+,→,→,→,→,→,→,→,→,→,→,→,→,→,→,→,→,→,→,→,→,→,→,→,→,→,→,→,→,→,→,→,→,→,→,→,→,→,→,→,→,→,→,→,→,→,→,→,→,→,→,→,→,⇢,+,+,+,+,→,→,→,-
-,-,-,-,↓,↓,⇡,⇡,-,-,-,-,-,-,-,-,-,-,-,-,-,-,-,-,-,-,-,-,-,-,-,↓,↓,⇡,⇡,-,-,-,-,-,-,-,-,-,-,-,-,-,-,-,-,-,-,-,-,-,-,-,-,-,-,-,-,-,-,-,-,-,-,-,-,-,-,-,-,-,-,-,-,-,-,-,-,-,-,-,-,-,↓,↓,⇡,⇡,-,-,-,-
-,-,-,-,↓,↓,↑,↑,-,-,-,-,-,-,-,-,-,-,-,-,-,-,-,-,-,-,-,-,-,-,-,↓,↓,↑,↑,-,-,-,-,-,-,-,-,-,-,-,-,-,-,-,-,-,-,-,-,-,-,-,-,-,-,-,-,-,-,-,-,-,-,-,-,-,-,-,-,-,-,-,-,-,-,-,-,-,-,-,-,-,↓,↓,↑,↑,-,-,-,-
-,-,-,-,↓,↓,↑,↑,-,-,-,-,-,-,-,-,-,-,-,-,-,-,-,-,-,-,-,-,-,-,-,↓,↓,↑,↑,-,-,-,-,-,-,-,-,-,-,-,-,-,-,-,-,-,-,-,-,-,-,-,-,-,-,-,-,-,-,-,-,-,-,-,-,-,-,-,-,-,-,-,-,-,-,-,-,-,-,-,-,-,↓,↓,↑,↑,-,-,-,-
-,-,-,-,↓,↓,↑,↑,-,-,-,-,-,-,-,-,-,-,-,-,-,-,-,-,-,-,-,-,-,-,-,↓,↓,↑,↑,-,-,-,-,-,-,-,-,-,-,-,-,-,-,-,-,-,-,-,-,-,-,-,-,-,-,-,-,-,-,-,-,-,-,-,-,-,-,-,-,-,-,-,-,-,-,-,-,-,-,-,-,-,↓,↓,↑,↑,-,-,-,-
-,-,-,-,↓,↓,↑,↑,-,-,-,-,-,-,-,-,-,-,-,-,-,-,-,-,-,-,-,-,-,-,-,↓,↓,↑,↑,-,-,-,-,-,-,-,-,-,-,-,-,-,-,-,-,-,-,-,-,-,-,-,-,-,-,-,-,-,-,-,-,-,-,-,-,-,-,-,-,-,-,-,-,-,-,-,-,-,-,-,-,-,↓,↓,↑,↑,-,-,-,-
-,-,-,-,↓,↓,↑,↑,-,-,-,-,-,-,-,-,-,-,-,-,-,-,-,-,-,-,-,-,-,-,-,↓,↓,↑,↑,-,-,-,-,-,-,-,-,-,-,-,-,-,-,-,-,-,-,-,-,-,-,-,-,-,-,-,-,-,-,-,-,-,-,-,-,-,-,-,-,-,-,-,-,-,-,-,-,-,-,-,-,-,↓,↓,↑,↑,-,-,-,-
-,-,-,-,↓,↓,↑,↑,-,-,-,-,-,-,-,-,-,-,-,-,-,-,-,-,-,-,-,-,-,-,-,↓,↓,↑,↑,-,-,-,-,-,-,-,-,-,-,-,-,-,-,-,-,-,-,-,-,-,-,-,-,-,-,-,-,-,-,-,-,-,-,-,-,-,-,-,-,-,-,-,-,-,-,-,-,-,-,-,-,-,↓,↓,↑,↑,-,-,-,-
-,-,-,-,↓,↓,↑,↑,-,-,-,-,-,-,-,-,-,-,-,-,-,-,-,-,-,-,-,-,-,-,-,↓,↓,↑,↑,-,-,-,-,-,-,-,-,-,-,-,-,-,-,-,-,-,-,-,-,-,-,-,-,-,-,-,-,-,-,-,-,-,-,-,-,-,-,-,-,-,-,-,-,-,-,-,-,-,-,-,-,-,↓,↓,↑,↑,-,-,-,-
-,-,-,-,↓,↓,↑,↑,-,-,-,-,-,-,-,-,-,-,-,-,-,-,-,-,-,-,-,-,-,-,-,↓,↓,↑,↑,-,-,-,-,-,-,-,-,-,-,-,-,-,-,-,-,-,-,-,-,-,-,-,-,-,-,-,-,-,-,-,-,-,-,-,-,-,-,-,-,-,-,-,-,-,-,-,-,-,-,-,-,-,↓,↓,↑,↑,-,-,-,-
-,-,-,-,↓,↓,↑,↑,-,-,-,-,-,-,-,-,-,-,-,-,-,-,-,-,-,-,-,-,-,-,-,↓,↓,↑,↑,-,-,-,-,-,-,-,-,-,-,-,-,-,-,-,-,-,-,-,-,-,-,-,-,-,-,-,-,-,-,-,-,-,-,-,-,-,-,-,-,-,-,-,-,-,-,-,-,-,-,-,-,-,↓,↓,↑,↑,-,-,-,-
-,-,-,-,↓,↓,↑,↑,-,-,-,-,-,-,-,-,-,-,-,-,-,-,-,-,-,-,-,-,-,-,-,↓,↓,↑,↑,-,-,-,-,-,-,-,-,-,-,-,-,-,-,-,-,-,-,-,-,-,-,-,-,-,-,-,-,-,-,-,-,-,-,-,-,-,-,-,-,-,-,-,-,-,-,-,-,-,-,-,-,-,↓,↓,↑,↑,-,-,-,-
-,-,-,-,↓,↓,↑,↑,-,-,-,-,-,-,-,-,-,-,-,-,-,-,-,-,-,-,-,-,-,-,-,↓,↓,↑,↑,-,-,-,-,-,-,-,-,-,-,-,-,-,-,-,-,-,-,-,-,-,-,-,-,-,-,-,-,-,-,-,-,-,-,-,-,-,-,-,-,-,-,-,-,-,-,-,-,-,-,-,-,-,↓,↓,↑,↑,-,-,-,-
-,-,-,-,⇣,⇣,↑,↑,-,-,-,-,-,-,-,-,-,-,-,-,-,-,-,-,-,-,-,-,-,-,-,⇣,⇣,↑,↑,-,-,-,-,-,-,-,-,-,-,-,-,-,-,-,-,-,-,-,-,-,-,-,-,-,-,-,-,-,-,-,-,-,-,-,-,-,-,-,-,-,-,-,-,-,-,-,-,-,-,-,-,-,⇣,⇣,↑,↑,-,-,-,-
-,←,←,←,+,+,+,+,⇠,←,←,←,←,←,←,←,←,←,←,←,←,←,←,←,←,←,←,←,←,←,←,+,+,+,+,⇠,←,←,←,←,←,←,←,←,←,←,←,←,←,←,←,←,←,←,←,←,←,←,←,←,←,←,←,←,←,←,←,←,←,←,←,←,←,←,←,←,←,←,←,←,←,←,←,←,←,←,←,←,+,+,+,+,⇠,←,←,-
-,←,←,←,+,+,+,+,⇠,←,←,←,←,←,←,←,←,←,←,←,←,←,←,←,←,←,←,←,←,←,←,+,+,+,+,⇠,←,←,←,←,←,←,←,←,←,←,←,←,←,←,←,←,←,←,←,←,←,←,←,←,←,←,←,←,←,←,←,←,←,←,←,←,←,←,←,←,←,←,←,←,←,←,←,←,←,←,←,←,+,+,+,+,⇠,←,←,-
-,→,→,⇢,+,+,+,+,→,→,→,→,→,→,→,→,→,→,→,→,→,→,→,→,→,→,→,→,→,→,⇢,+,+,+,+,→,→,→,→,→,→,→,→,→,→,→,→,→,→,→,→,→,→,→,→,→,→,→,→,→,→,→,→,→,→,→,→,→,→,→,→,→,→,→,→,→,→,→,→,→,→,→,→,→,→,→,→,⇢,+,+,+,+,→,→,→,-
-,→,→,⇢,+,+,+,+,→,→,→,→,→,→,→,→,→,→,→,→,→,→,→,→,→,→,→,→,→,→,⇢,+,+,+,+,→,→,→,→,→,→,→,→,→,→,→,→,→,→,→,→,→,→,→,→,→,→,→,→,→,→,→,→,→,→,→,→,→,→,→,→,→,→,→,→,→,→,→,→,→,→,→,→,→,→,→,→,⇢,+,+,+,+,→,→,→,-
-,-,-,-,↓,↓,⇡,⇡,-,-,-,-,-,-,-,-,-,-,-,-,-,-,-,-,-,-,-,-,-,-,-,↓,↓,⇡,⇡,-,-,-,-,-,-,-,-,-,-,-,-,-,-,-,-,-,-,-,-,-,-,-,-,-,-,-,-,-,-,-,-,-,-,-,-,-,-,-,-,-,-,-,-,-,-,-,-,-,-,-,-,-,↓,↓,⇡,⇡,-,-,-,-
-,-,-,-,↓,↓,↑,↑,-,-,-,-,-,-,-,-,-,-,-,-,-,-,-,-,-,-,-,-,-,-,-,↓,↓,↑,↑,-,-,-,-,-,-,-,-,-,-,-,-,-,-,-,-,-,-,-,-,-,-,-,-,-,-,-,-,-,-,-,-,-,-,-,-,-,-,-,-,-,-,-,-,-,-,-,-,-,-,-,-,-,↓,↓,↑,↑,-,-,-,-
-,-,-,-,↓,↓,↑,↑,-,-,-,-,-,-,-,-,-,-,-,-,-,-,-,-,-,-,-,-,-,-,-,↓,↓,↑,↑,-,-,-,-,-,-,-,-,-,-,-,-,-,-,-,-,-,-,-,-,-,-,-,-,-,-,-,-,-,-,-,-,-,-,-,-,-,-,-,-,-,-,-,-,-,-,-,-,-,-,-,-,-,↓,↓,↑,↑,-,-,-,-
-,-,-,-,↓,↓,↑,↑,-,-,-,-,-,-,-,-,-,-,-,-,-,-,-,-,-,-,-,-,-,-,-,↓,↓,↑,↑,-,-,-,-,-,-,-,-,-,-,-,-,-,-,-,-,-,-,-,-,-,-,-,-,-,-,-,-,-,-,-,-,-,-,-,-,-,-,-,-,-,-,-,-,-,-,-,-,-,-,-,-,-,↓,↓,↑,↑,-,-,-,-
-,-,-,-,↓,↓,↑,↑,-,-,-,-,-,-,-,-,-,-,-,-,-,-,-,-,-,-,-,-,-,-,-,↓,↓,↑,↑,-,-,-,-,-,-,-,-,-,-,-,-,-,-,-,-,-,-,-,-,-,-,-,-,-,-,-,-,-,-,-,-,-,-,-,-,-,-,-,-,-,-,-,-,-,-,-,-,-,-,-,-,-,↓,↓,↑,↑,-,-,-,-
-,-,-,-,↓,↓,↑,↑,-,-,-,-,-,-,-,-,-,-,-,-,-,-,-,-,-,-,-,-,-,-,-,↓,↓,↑,↑,-,-,-,-,-,-,-,-,-,-,-,-,-,-,-,-,-,-,-,-,-,-,-,-,-,-,-,-,-,-,-,-,-,-,-,-,-,-,-,-,-,-,-,-,-,-,-,-,-,-,-,-,-,↓,↓,↑,↑,-,-,-,-
-,-,-,-,↓,↓,↑,↑,-,-,-,-,-,-,-,-,-,-,-,-,-,-,-,-,-,-,-,-,-,-,-,↓,↓,↑,↑,-,-,-,-,-,-,-,-,-,-,-,-,-,-,-,-,-,-,-,-,-,-,-,-,-,-,-,-,-,-,-,-,-,-,-,-,-,-,-,-,-,-,-,-,-,-,-,-,-,-,-,-,-,↓,↓,↑,↑,-,-,-,-
-,-,-,-,↓,↓,↑,↑,-,-,-,-,-,-,-,-,-,-,-,-,-,-,-,-,-,-,-,-,-,-,-,↓,↓,↑,↑,-,-,-,-,-,-,-,-,-,-,-,-,-,-,-,-,-,-,-,-,-,-,-,-,-,-,-,-,-,-,-,-,-,-,-,-,-,-,-,-,-,-,-,-,-,-,-,-,-,-,-,-,-,↓,↓,↑,↑,-,-,-,-
-,-,-,-,↓,↓,↑,↑,-,-,-,-,-,-,-,-,-,-,-,-,-,-,-,-,-,-,-,-,-,-,-,↓,↓,↑,↑,-,-,-,-,-,-,-,-,-,-,-,-,-,-,-,-,-,-,-,-,-,-,-,-,-,-,-,-,-,-,-,-,-,-,-,-,-,-,-,-,-,-,-,-,-,-,-,-,-,-,-,-,-,↓,↓,↑,↑,-,-,-,-
-,-,-,-,↓,↓,↑,↑,-,-,-,-,-,-,-,-,-,-,-,-,-,-,-,-,-,-,-,-,-,-,-,↓,↓,↑,↑,-,-,-,-,-,-,-,-,-,-,-,-,-,-,-,-,-,-,-,-,-,-,-,-,-,-,-,-,-,-,-,-,-,-,-,-,-,-,-,-,-,-,-,-,-,-,-,-,-,-,-,-,-,↓,↓,↑,↑,-,-,-,-
-,-,-,-,↓,↓,↑,↑,-,-,-,-,-,-,-,-,-,-,-,-,-,-,-,-,-,-,-,-,-,-,-,↓,↓,↑,↑,-,-,-,-,-,-,-,-,-,-,-,-,-,-,-,-,-,-,-,-,-,-,-,-,-,-,-,-,-,-,-,-,-,-,-,-,-,-,-,-,-,-,-,-,-,-,-,-,-,-,-,-,-,↓,↓,↑,↑,-,-,-,-
-,-,-,-,↓,↓,↑,↑,-,-,-,-,-,-,-,-,-,-,-,-,-,-,-,-,-,-,-,-,-,-,-,↓,↓,↑,↑,-,-,-,-,-,-,-,-,-,-,-,-,-,-,-,-,-,-,-,-,-,-,-,-,-,-,-,-,-,-,-,-,-,-,-,-,-,-,-,-,-,-,-,-,-,-,-,-,-,-,-,-,-,↓,↓,↑,↑,-,-,-,-
-,-,-,-,↓,↓,↑,↑,-,-,-,-,-,-,-,-,-,-,-,-,-,-,-,-,-,-,-,-,-,-,-,↓,↓,↑,↑,-,-,-,-,-,-,-,-,-,-,-,-,-,-,-,-,-,-,-,-,-,-,-,-,-,-,-,-,-,-,-,-,-,-,-,-,-,-,-,-,-,-,-,-,-,-,-,-,-,-,-,-,-,↓,↓,↑,↑,-,-,-,-
-,-,-,-,↓,↓,↑,↑,-,-,-,-,-,-,-,-,-,-,-,-,-,-,-,-,-,-,-,-,-,-,-,↓,↓,↑,↑,-,-,-,-,-,-,-,-,-,-,-,-,-,-,-,-,-,-,-,-,-,-,-,-,-,-,-,-,-,-,-,-,-,-,-,-,-,-,-,-,-,-,-,-,-,-,-,-,-,-,-,-,-,↓,↓,↑,↑,-,-,-,-
-,-,-,-,↓,↓,↑,↑,-,-,-,-,-,-,-,-,-,-,-,-,-,-,-,-,-,-,-,-,-,-,-,↓,↓,↑,↑,-,-,-,-,-,-,-,-,-,-,-,-,-,-,-,-,-,-,-,-,-,-,-,-,-,-,-,-,-,-,-,-,-,-,-,-,-,-,-,-,-,-,-,-,-,-,-,-,-,-,-,-,-,↓,↓,↑,↑,-,-,-,-
-,-,-,-,↓,↓,↑,↑,-,-,-,-,-,-,-,-,-,-,-,-,-,-,-,-,-,-,-,-,-,-,-,↓,↓,↑,↑,-,-,-,-,-,-,-,-,-,-,-,-,-,-,-,-,-,-,-,-,-,-,-,-,-,-,-,-,-,-,-,-,-,-,-,-,-,-,-,-,-,-,-,-,-,-,-,-,-,-,-,-,-,↓,↓,↑,↑,-,-,-,-
-,-,-,-,↓,↓,↑,↑,-,-,-,-,-,-,-,-,-,-,-,-,-,-,-,-,-,-,-,-,-,-,-,↓,↓,↑,↑,-,-,-,-,-,-,-,-,-,-,-,-,-,-,-,-,-,-,-,-,-,-,-,-,-,-,-,-,-,-,-,-,-,-,-,-,-,-,-,-,-,-,-,-,-,-,-,-,-,-,-,-,-,↓,↓,↑,↑,-,-,-,-
-,-,-,-,↓,↓,↑,↑,-,-,-,-,-,-,-,-,-,-,-,-,-,-,-,-,-,-,-,-,-,-,-,↓,↓,↑,↑,-,-,-,-,-,-,-,-,-,-,-,-,-,-,-,-,-,-,-,-,-,-,-,-,-,-,-,-,-,-,-,-,-,-,-,-,-,-,-,-,-,-,-,-,-,-,-,-,-,-,-,-,-,↓,↓,↑,↑,-,-,-,-
-,-,-,-,↓,↓,↑,↑,-,-,-,-,-,-,-,-,-,-,-,-,-,-,-,-,-,-,-,-,-,-,-,↓,↓,↑,↑,-,-,-,-,-,-,-,-,-,-,-,-,-,-,-,-,-,-,-,-,-,-,-,-,-,-,-,-,-,-,-,-,-,-,-,-,-,-,-,-,-,-,-,-,-,-,-,-,-,-,-,-,-,↓,↓,↑,↑,-,-,-,-
-,-,-,-,↓,↓,↑,↑,-,-,-,-,-,-,-,-,-,-,-,-,-,-,-,-,-,-,-,-,-,-,-,↓,↓,↑,↑,-,-,-,-,-,-,-,-,-,-,-,-,-,-,-,-,-,-,-,-,-,-,-,-,-,-,-,-,-,-,-,-,-,-,-,-,-,-,-,-,-,-,-,-,-,-,-,-,-,-,-,-,-,↓,↓,↑,↑,-,-,-,-
-,-,-,-,↓,↓,↑,↑,-,-,-,-,-,-,-,-,-,-,-,-,-,-,-,-,-,-,-,-,-,-,-,↓,↓,↑,↑,-,-,-,-,-,-,-,-,-,-,-,-,-,-,-,-,-,-,-,-,-,-,-,-,-,-,-,-,-,-,-,-,-,-,-,-,-,-,-,-,-,-,-,-,-,-,-,-,-,-,-,-,-,↓,↓,↑,↑,-,-,-,-
-,-,-,-,↓,↓,↑,↑,-,-,-,-,-,-,-,-,-,-,-,-,-,-,-,-,-,-,-,-,-,-,-,↓,↓,↑,↑,-,-,-,-,-,-,-,-,-,-,-,-,-,-,-,-,-,-,-,-,-,-,-,-,-,-,-,-,-,-,-,-,-,-,-,-,-,-,-,-,-,-,-,-,-,-,-,-,-,-,-,-,-,↓,↓,↑,↑,-,-,-,-
-,-,-,-,↓,↓,↑,↑,-,-,-,-,-,-,-,-,-,-,-,-,-,-,-,-,-,-,-,-,-,-,-,↓,↓,↑,↑,-,-,-,-,-,-,-,-,-,-,-,-,-,-,-,-,-,-,-,-,-,-,-,-,-,-,-,-,-,-,-,-,-,-,-,-,-,-,-,-,-,-,-,-,-,-,-,-,-,-,-,-,-,↓,↓,↑,↑,-,-,-,-
-,-,-,-,↓,↓,↑,↑,-,-,-,-,-,-,-,-,-,-,-,-,-,-,-,-,-,-,-,-,-,-,-,↓,↓,↑,↑,-,-,-,-,-,-,-,-,-,-,-,-,-,-,-,-,-,-,-,-,-,-,-,-,-,-,-,-,-,-,-,-,-,-,-,-,-,-,-,-,-,-,-,-,-,-,-,-,-,-,-,-,-,↓,↓,↑,↑,-,-,-,-
-,-,-,-,⇣,⇣,↑,↑,-,-,-,-,-,-,-,-,-,-,-,-,-,-,-,-,-,-,-,-,-,-,-,⇣,⇣,↑,↑,-,-,-,-,-,-,-,-,-,-,-,-,-,-,-,-,-,-,-,-,-,-,-,-,-,-,-,-,-,-,-,-,-,-,-,-,-,-,-,-,-,-,-,-,-,-,-,-,-,-,-,-,-,⇣,⇣,↑,↑,-,-,-,-
-,←,←,←,+,+,+,+,⇠,←,←,←,←,←,←,←,←,←,←,←,←,←,←,←,←,←,←,←,←,←,←,+,+,+,+,⇠,←,←,←,←,←,←,←,←,←,←,←,←,←,←,←,←,←,←,←,←,←,←,←,←,←,←,←,←,←,←,←,←,←,←,←,←,←,←,←,←,←,←,←,←,←,←,←,←,←,←,←,←,+,+,+,+,⇠,←,←,-
-,←,←,←,+,+,+,+,⇠,←,←,←,←,←,←,←,←,←,←,←,←,←,←,←,←,←,←,←,←,←,←,+,+,+,+,⇠,←,←,←,←,←,←,←,←,←,←,←,←,←,←,←,←,←,←,←,←,←,←,←,←,←,←,←,←,←,←,←,←,←,←,←,←,←,←,←,←,←,←,←,←,←,←,←,←,←,←,←,←,+,+,+,+,⇠,←,←,-
-,→,→,⇢,+,+,+,+,→,→,→,→,→,→,→,→,→,→,→,→,→,→,→,→,→,→,→,→,→,→,⇢,+,+,+,+,→,→,→,→,→,→,→,→,→,→,→,→,→,→,→,→,→,→,→,→,→,→,→,→,→,→,→,→,→,→,→,→,→,→,→,→,→,→,→,→,→,→,→,→,→,→,→,→,→,→,→,→,⇢,+,+,+,+,→,→,→,-
-,→,→,⇢,+,+,+,+,→,→,→,→,→,→,→,→,→,→,→,→,→,→,→,→,→,→,→,→,→,→,⇢,+,+,+,+,→,→,→,→,→,→,→,→,→,→,→,→,→,→,→,→,→,→,→,→,→,→,→,→,→,→,→,→,→,→,→,→,→,→,→,→,→,→,→,→,→,→,→,→,→,→,→,→,→,→,→,→,⇢,+,+,+,+,→,→,→,-
-,-,-,-,↓,↓,⇡,⇡,-,-,-,-,-,-,-,-,-,-,-,-,-,-,-,-,-,-,-,-,-,-,-,↓,↓,⇡,⇡,-,-,-,-,-,-,-,-,-,-,-,-,-,-,-,-,-,-,-,-,-,-,-,-,-,-,-,-,-,-,-,-,-,-,-,-,-,-,-,-,-,-,-,-,-,-,-,-,-,-,-,-,-,↓,↓,⇡,⇡,-,-,-,-
-,-,-,-,↓,↓,↑,↑,-,-,-,-,-,-,-,-,-,-,-,-,-,-,-,-,-,-,-,-,-,-,-,↓,↓,↑,↑,-,-,-,-,-,-,-,-,-,-,-,-,-,-,-,-,-,-,-,-,-,-,-,-,-,-,-,-,-,-,-,-,-,-,-,-,-,-,-,-,-,-,-,-,-,-,-,-,-,-,-,-,-,↓,↓,↑,↑,-,-,-,-
-,-,-,-,↓,↓,↑,↑,-,-,-,-,-,-,-,-,-,-,-,-,-,-,-,-,-,-,-,-,-,-,-,↓,↓,↑,↑,-,-,-,-,-,-,-,-,-,-,-,-,-,-,-,-,-,-,-,-,-,-,-,-,-,-,-,-,-,-,-,-,-,-,-,-,-,-,-,-,-,-,-,-,-,-,-,-,-,-,-,-,-,↓,↓,↑,↑,-,-,-,-
-,-,-,-,-,-,-,-,-,-,-,-,-,-,-,-,-,-,-,-,-,-,-,-,-,-,-,-,-,-,-,-,-,-,-,-,-,-,-,-,-,-,-,-,-,-,-,-,-,-,-,-,-,-,-,-,-,-,-,-,-,-,-,-,-,-,-,-,-,-,-,-,-,-,-,-,-,-,-,-,-,-,-,-,-,-,-,-,-,-,-,-,-,-,-,-
