-,-,-,-,-,-,-,-,-,-,-,-,-,-,-,-,-,-,-,-,-,-,-,-,-,-,-,-,-,-,-,-,-,-,-,-,-,-,-,-,-,-,-,-,-,-,-,-,-,-,-,-,-,-,-,-,-,-,-,-,-,-,-,-,-,-,-,-,-,-,-,-,-,-,-,-,-,-,-,-,-,-,-,-,-,-,-,-,-,-,-,-,-,-
-,-,-,-,↓,↑,-,-,-,-,-,-,-,-,-,-,-,-,-,-,-,-,-,-,-,-,-,-,-,↓,↓,↑,↑,-,-,-,-,-,-,-,-,-,-,-,-,-,-,-,-,-,-,-,-,-,-,-,-,-,-,-,-,-,-,-,-,-,-,-,-,-,-,-,-,-,-,-,-,-,-,-,-,-,-,-,-,-,↓,↓,↑,↑,-,-,-,-
-,-,-,-,↓,↑,-,-,-,-,-,-,-,-,-,-,-,-,-,-,-,-,-,-,-,-,-,-,-,↓,↓,↑,↑,-,-,-,-,-,-,-,-,-,-,-,-,-,-,-,-,-,-,-,-,-,-,-,-,-,-,-,-,-,-,-,-,-,-,-,-,-,-,-,-,-,-,-,-,-,-,-,-,-,-,-,-,-,↓,↓,↑,↑,-,-,-,-
-,-,-,-,⇣,↑,-,-,-,-,-,-,-,-,-,-,-,-,-,-,-,-,-,-,-,-,-,-,-,⇣,⇣,↑,↑,-,-,-,-,-,-,-,-,-,-,-,-,-,-,-,-,-,-,-,-,-,-,-,-,-,-,-,-,-,-,-,-,-,-,-,-,-,-,-,-,-,-,-,-,-,-,-,-,-,-,-,-,-,⇣,⇣,↑,↑,-,-,-,-
-,←,←,←,+,+,⇠,←,←,←,←,←,←,←,←,←,←,←,←,←,←,←,←,←,←,←,←,←,←,+,+,+,+,⇠,←,←,←,←,←,←,←,←,←,←,←,←,←,←,←,←,←,←,←,←,←,←,←,←,←,←,←,←,←,←,←,←,←,←,←,←,←,←,←,←,←,←,←,←,←,←,←,←,←,←,←,←,+,+,+,+,⇠,←,←,-
-,→,→,⇢,+,+,→,→,→,→,→,→,→,→,→,→,→,→,→,→,→,→,→,→,→,→,→,→,⇢,+,+,+,+,→,→,→,→,→,→,→,→,→,→,→,→,→,→,→,→,→,→,→,→,→,→,→,→,→,→,→,→,→,→,→,→,→,→,→,→,→,→,→,→,→,→,→,→,→,→,→,→,→,→,→,→,→,+,+,+,+,→,→,→,-
-,-,-,-,↓,↑,-,-,-,-,-,-,-,-,-,-,-,-,-,-,-,-,-,-,-,-,-,-,-,↓,↓,⇡,⇡,-,-,-,-,-,-,-,-,-,-,-,-,-,-,-,-,-,-,-,-,-,-,-,-,-,-,-,-,-,-,-,-,-,-,-,-,-,-,-,-,-,-,-,-,-,-,-,-,-,-,-,-,-,↓,↓,↑,↑,-,-,-,-
-,-,-,-,↓,↑,-,-,-,-,-,-,-,-,-,-,-,-,-,-,-,-,-,-,-,-,-,-,-,↓,↓,↑,↑,-,-,-,-,-,-,-,-,-,-,-,-,-,-,-,-,-,-,-,-,-,-,-,-,-,-,-,-,-,-,-,-,-,-,-,-,-,-,-,-,-,-,-,-,-,-,-,-,-,-,-,-,-,↓,↓,↑,↑,-,-,-,-
-,-,-,-,↓,↑,-,-,-,-,-,-,-,-,-,-,-,-,-,-,-,-,-,-,-,-,-,-,-,↓,↓,↑,↑,-,-,-,-,-,-,-,-,-,-,-,-,-,-,-,-,-,-,-,-,-,-,-,-,-,-,-,-,-,-,-,-,-,-,-,-,-,-,-,-,-,-,-,-,-,-,-,-,-,-,-,-,-,↓,↓,↑,↑,-,-,-,-
-,-,-,-,↓,↑,-,-,-,-,-,-,-,-,-,-,-,-,-,-,-,-,-,-,-,-,-,-,-,↓,↓,↑,↑,-,-,-,-,-,-,-,-,-,-,-,-,-,-,-,-,-,-,-,-,-,-,-,-,-,-,-,-,-,-,-,-,-,-,-,-,-,-,-,-,-,-,-,-,-,-,-,-,-,-,-,-,-,↓,↓,↑,↑,-,-,-,-
-,-,-,-,↓,↑,-,-,-,-,-,-,-,-,-,-,-,-,-,-,-,-,-,-,-,-,-,-,-,↓,↓,↑,↑,-,-,-,-,-,-,-,-,-,-,-,-,-,-,-,-,-,-,-,-,-,-,-,-,-,-,-,-,-,-,-,-,-,-,-,-,-,-,-,-,-,-,-,-,-,-,-,-,-,-,-,-,-,↓,↓,↑,↑,-,-,-,-
-,-,-,-,↓,↑,-,-,-,-,-,-,-,-,-,-,-,-,-,-,-,-,-,-,-,-,-,-,-,↓,↓,↑,↑,-,-,-,-,-,-,-,-,-,-,-,-,-,-,-,-,-,-,-,-,-,-,-,-,-,-,-,-,-,-,-,-,-,-,-,-,-,-,-,-,-,-,-,-,-,-,-,-,-,-,-,-,-,↓,↓,↑,↑,-,-,-,-
-,-,-,-,↓,↑,-,-,-,-,-,-,-,-,-,-,-,-,-,-,-,-,-,-,-,-,-,-,-,↓,↓,↑,↑,-,-,-,-,-,-,-,-,-,-,-,-,-,-,-,-,-,-,-,-,-,-,-,-,-,-,-,-,-,-,-,-,-,-,-,-,-,-,-,-,-,-,-,-,-,-,-,-,-,-,-,-,-,↓,↓,↑,↑,-,-,-,-
-,-,-,-,↓,↑,-,-,-,-,-,-,-,-,-,-,-,-,-,-,-,-,-,-,-,-,-,-,-,↓,↓,↑,↑,-,-,-,-,-,-,-,-,-,-,-,-,-,-,-,-,-,-,-,-,-,-,-,-,-,-,-,-,-,-,-,-,-,-,-,-,-,-,-,-,-,-,-,-,-,-,-,-,-,-,-,-,-,↓,↓,↑,↑,-,-,-,-
-,-,-,-,↓,↑,-,-,-,-,-,-,-,-,-,-,-,-,-,-,-,-,-,-,-,-,-,-,-,↓,↓,↑,↑,-,-,-,-,-,-,-,-,-,-,-,-,-,-,-,-,-,-,-,-,-,-,-,-,-,-,-,-,-,-,-,-,-,-,-,-,-,-,-,-,-,-,-,-,-,-,-,-,-,-,-,-,-,↓,↓,↑,↑,-,-,-,-
-,-,-,-,↓,↑,-,-,-,-,-,-,-,-,-,-,-,-,-,-,-,-,-,-,-,-,-,-,-,↓,↓,↑,↑,-,-,-,-,-,-,-,-,-,-,-,-,-,-,-,-,-,-,-,-,-,-,-,-,-,-,-,-,-,-,-,-,-,-,-,-,-,-,-,-,-,-,-,-,-,-,-,-,-,-,-,-,-,↓,↓,↑,↑,-,-,-,-
-,-,-,-,↓,↑,-,-,-,-,-,-,-,-,-,-,-,-,-,-,-,-,-,-,-,-,-,-,-,↓,↓,↑,↑,-,-,-,-,-,-,-,-,-,-,-,-,-,-,-,-,-,-,-,-,-,-,-,-,-,-,-,-,-,-,-,-,-,-,-,-,-,-,-,-,-,-,-,-,-,-,-,-,-,-,-,-,-,↓,↓,↑,↑,-,-,-,-
-,-,-,-,↓,↑,-,-,-,-,-,-,-,-,-,-,-,-,-,-,-,-,-,-,-,-,-,-,-,↓,↓,↑,↑,-,-,-,-,-,-,-,-,-,-,-,-,-,-,-,-,-,-,-,-,-,-,-,-,-,-,-,-,-,-,-,-,-,-,-,-,-,-,-,-,-,-,-,-,-,-,-,-,-,-,-,-,-,↓,↓,↑,↑,-,-,-,-
-,-,-,-,⇣,↑,-,-,-,-,-,-,-,-,-,-,-,-,-,-,-,-,-,-,-,-,-,-,-,⇣,⇣,↑,↑,-,-,-,-,-,-,-,-,-,-,-,-,-,-,-,-,-,-,-,-,-,-,-,-,-,-,-,-,-,-,-,-,-,-,-,-,-,-,-,-,-,-,-,-,-,-,-,-,-,-,-,-,-,⇣,⇣,↑,↑,-,-,-,-
-,←,←,←,+,+,⇠,←,←,←,←,←,←,←,←,←,←,←,←,←,←,←,←,←,←,←,←,←,←,+,+,+,+,⇠,←,←,←,←,←,←,←,←,←,←,←,←,←,←,←,←,←,←,←,←,←,←,←,←,←,←,←,←,←,←,←,←,←,←,←,←,←,←,←,←,←,←,←,←,←,←,←,←,←,←,←,←,+,+,+,+,⇠,←,←,-
-,←,←,←,+,+,⇠,←,←,←,←,←,←,←,←,←,←,←,←,←,←,←,←,←,←,←,←,←,←,+,+,+,+,⇠,←,←,←,←,←,←,←,←,←,←,←,←,←,←,←,←,←,←,←,←,←,←,←,←,←,←,←,←,←,←,←,←,←,←,←,←,←,←,←,←,←,←,←,←,←,←,←,←,←,←,←,←,+,+,+,+,⇠,←,←,-
-,←,←,←,+,+,⇠,←,←,←,←,←,←,←,←,←,←,←,←,←,←,←,←,←,←,←,←,←,←,+,+,+,+,⇠,←,←,←,←,←,←,←,←,←,←,←,←,←,←,←,←,←,←,←,←,←,←,←,←,←,←,←,←,←,←,←,←,←,←,←,←,←,←,←,←,←,←,←,←,←,←,←,←,←,←,←,←,+,+,+,+,⇠,←,←,-
-,→,→,⇢,+,+,→,→,→,→,→,→,→,→,→,→,→,→,→,→,→,→,→,→,→,→,→,→,⇢,+,+,+,+,→,→,→,→,→,→,→,→,→,→,→,→,→,→,→,→,→,→,→,→,→,→,→,→,→,→,→,→,→,→,→,→,→,→,→,→,→,→,→,→,→,→,→,→,→,→,→,→,→,→,→,→,⇢,+,+,+,+,→,→,→,-
-,→,→,⇢,+,+,→,→,→,→,→,→,→,→,→,→,→,→,→,→,→,→,→,→,→,→,→,→,⇢,+,+,+,+,→,→,→,→,→,→,→,→,→,→,→,→,→,→,→,→,→,→,→,→,→,→,→,→,→,→,→,→,→,→,→,→,→,→,→,→,→,→,→,→,→,→,→,→,→,→,→,→,→,→,→,→,⇢,+,+,+,+,→,→,→,-
-,→,→,⇢,+,+,→,→,→,→,→,→,→,→,→,→,→,→,→,→,→,→,→,→,→,→,→,→,⇢,+,+,+,+,→,→,→,→,→,→,→,→,→,→,→,→,→,→,→,→,→,→,→,→,→,→,→,→,→,→,→,→,→,→,→,→,→,→,→,→,→,→,→,→,→,→,→,→,→,→,→,→,→,→,→,→,⇢,+,+,+,+,→,→,→,-
-,-,-,-,↓,⇡,-,-,-,-,-,-,-,-,-,-,-,-,-,-,-,-,-,-,-,-,-,-,-,↓,↓,⇡,⇡,-,-,-,-,-,-,-,-,-,-,-,-,-,-,-,-,-,-,-,-,-,-,-,-,-,-,-,-,-,-,-,-,-,-,-,-,-,-,-,-,-,-,-,-,-,-,-,-,-,-,-,-,-,↓,↓,⇡,⇡,-,-,-,-
-,-,-,-,↓,↑,-,-,-,-,-,-,-,-,-,-,-,-,-,-,-,-,-,-,-,-,-,-,-,↓,↓,↑,↑,-,-,-,-,-,-,-,-,-,-,-,-,-,-,-,-,-,-,-,-,-,-,-,-,-,-,-,-,-,-,-,-,-,-,-,-,-,-,-,-,-,-,-,-,-,-,-,-,-,-,-,-,-,↓,↓,↑,↑,-,-,-,-
-,-,-,-,↓,↑,-,-,-,-,-,-,-,-,-,-,-,-,-,-,-,-,-,-,-,-,-,-,-,↓,↓,↑,↑,-,-,-,-,-,-,-,-,-,-,-,-,-,-,-,-,-,-,-,-,-,-,-,-,-,-,-,-,-,-,-,-,-,-,-,-,-,-,-,-,-,-,-,-,-,-,-,-,-,-,-,-,-,↓,↓,↑,↑,-,-,-,-
-,-,-,-,↓,↑,-,-,-,-,-,-,-,-,-,-,-,-,-,-,-,-,-,-,-,-,-,-,-,↓,↓,↑,↑,-,-,-,-,-,-,-,-,-,-,-,-,-,-,-,-,-,-,-,-,-,-,-,-,-,-,-,-,-,-,-,-,-,-,-,-,-,-,-,-,-,-,-,-,-,-,-,-,-,-,-,-,-,↓,↓,↑,↑,-,-,-,-
-,-,-,-,↓,↑,-,-,-,-,-,-,-,-,-,-,-,-,-,-,-,-,-,-,-,-,-,-,-,↓,↓,↑,↑,-,-,-,-,-,-,-,-,-,-,-,-,-,-,-,-,-,-,-,-,-,-,-,-,-,-,-,-,-,-,-,-,-,-,-,-,-,-,-,-,-,-,-,-,-,-,-,-,-,-,-,-,-,↓,↓,↑,↑,-,-,-,-
-,-,-,-,↓,↑,-,-,-,-,-,-,-,-,-,-,-,-,-,-,-,-,-,-,-,-,-,-,-,↓,↓,↑,↑,-,-,-,-,-,-,-,-,-,-,-,-,-,-,-,-,-,-,-,-,-,-,-,-,-,-,-,-,-,-,-,-,-,-,-,-,-,-,-,-,-,-,-,-,-,-,-,-,-,-,-,-,-,↓,↓,↑,↑,-,-,-,-
-,-,-,-,↓,↑,-,-,-,-,-,-,-,-,-,-,-,-,-,-,-,-,-,-,-,-,-,-,-,↓,↓,↑,↑,-,-,-,-,-,-,-,-,-,-,-,-,-,-,-,-,-,-,-,-,-,-,-,-,-,-,-,-,-,-,-,-,-,-,-,-,-,-,-,-,-,-,-,-,-,-,-,-,-,-,-,-,-,↓,↓,↑,↑,-,-,-,-
-,-,-,-,↓,↑,-,-,-,-,-,-,-,-,-,-,-,-,-,-,-,-,-,-,-,-,-,-,-,↓,↓,↑,↑,-,-,-,-,-,-,-,-,-,-,-,-,-,-,-,-,-,-,-,-,-,-,-,-,-,-,-,-,-,-,-,-,-,-,-,-,-,-,-,-,-,-,-,-,-,-,-,-,-,-,-,-,-,↓,↓,↑,↑,-,-,-,-
-,-,-,-,↓,↑,-,-,-,-,-,-,-,-,-,-,-,-,-,-,-,-,-,-,-,-,-,-,-,↓,↓,↑,↑,-,-,-,-,-,-,-,-,-,-,-,-,-,-,-,-,-,-,-,-,-,-,-,-,-,-,-,-,-,-,-,-,-,-,-,-,-,-,-,-,-,-,-,-,-,-,-,-,-,-,-,-,-,↓,↓,↑,↑,-,-,-,-
-,-,-,-,↓,↑,-,-,-,-,-,-,-,-,-,-,-,-,-,-,-,-,-,-,-,-,-,-,-,↓,↓,↑,↑,-,-,-,-,-,-,-,-,-,-,-,-,-,-,-,-,-,-,-,-,-,-,-,-,-,-,-,-,-,-,-,-,-,-,-,-,-,-,-,-,-,-,-,-,-,-,-,-,-,-,-,-,-,↓,↓,↑,↑,-,-,-,-
-,-,-,-,↓,↑,-,-,-,-,-,-,-,-,-,-,-,-,-,-,-,-,-,-,-,-,-,-,-,↓,↓,↑,↑,-,-,-,-,-,-,-,-,-,-,-,-,-,-,-,-,-,-,-,-,-,-,-,-,-,-,-,-,-,-,-,-,-,-,-,-,-,-,-,-,-,-,-,-,-,-,-,-,-,-,-,-,-,↓,↓,↑,↑,-,-,-,-
-,-,-,-,↓,↑,-,-,-,-,-,-,-,-,-,-,-,-,-,-,-,-,-,-,-,-,-,-,-,↓,↓,↑,↑,-,-,-,-,-,-,-,-,-,-,-,-,-,-,-,-,-,-,-,-,-,-,-,-,-,-,-,-,-,-,-,-,-,-,-,-,-,-,-,-,-,-,-,-,-,-,-,-,-,-,-,-,-,↓,↓,↑,↑,-,-,-,-
-,-,-,-,↓,↑,-,-,-,-,-,-,-,-,-,-,-,-,-,-,-,-,-,-,-,-,-,-,-,↓,↓,↑,↑,-,-,-,-,-,-,-,-,-,-,-,-,-,-,-,-,-,-,-,-,-,-,-,-,-,-,-,-,-,-,-,-,-,-,-,-,-,-,-,-,-,-,-,-,-,-,-,-,-,-,-,-,-,↓,↓,↑,↑,-,-,-,-
-,-,-,-,↓,↑,-,-,-,-,-,-,-,-,-,-,-,-,-,-,-,-,-,-,-,-,-,-,-,↓,↓,↑,↑,-,-,-,-,-,-,-,-,-,-,-,-,-,-,-,-,-,-,-,-,-,-,-,-,-,-,-,-,-,-,-,-,-,-,-,-,-,-,-,-,-,-,-,-,-,-,-,-,-,-,-,-,-,↓,↓,↑,↑,-,-,-,-
-,-,-,-,↓,↑,-,-,-,-,-,-,-,-,-,-,-,-,-,-,-,-,-,-,-,-,-,-,-,↓,↓,↑,↑,-,-,-,-,-,-,-,-,-,-,-,-,-,-,-,-,-,-,-,-,-,-,-,-,-,-,-,-,-,-,-,-,-,-,-,-,-,-,-,-,-,-,-,-,-,-,-,-,-,-,-,-,-,↓,↓,↑,↑,-,-,-,-
-,-,-,-,↓,↑,-,-,-,-,-,-,-,-,-,-,-,-,-,-,-,-,-,-,-,-,-,-,-,↓,↓,↑,↑,-,-,-,-,-,-,-,-,-,-,-,-,-,-,-,-,-,-,-,-,-,-,-,-,-,-,-,-,-,-,-,-,-,-,-,-,-,-,-,-,-,-,-,-,-,-,-,-,-,-,-,-,-,↓,↓,↑,↑,-,-,-,-
-,-,-,-,↓,↑,-,-,-,-,-,-,-,-,-,-,-,-,-,-,-,-,-,-,-,-,-,-,-,↓,↓,↑,↑,-,-,-,-,-,-,-,-,-,-,-,-,-,-,-,-,-,-,-,-,-,-,-,-,-,-,-,-,-,-,-,-,-,-,-,-,-,-,-,-,-,-,-,-,-,-,-,-,-,-,-,-,-,↓,↓,↑,↑,-,-,-,-
-,-,-,-,↓,↑,-,-,-,-,-,-,-,-,-,-,-,-,-,-,-,-,-,-,-,-,-,-,-,↓,↓,↑,↑,-,-,-,-,-,-,-,-,-,-,-,-,-,-,-,-,-,-,-,-,-,-,-,-,-,-,-,-,-,-,-,-,-,-,-,-,-,-,-,-,-,-,-,-,-,-,-,-,-,-,-,-,-,↓,↓,↑,↑,-,-,-,-
-,-,-,-,↓,↑,-,-,-,-,-,-,-,-,-,-,-,-,-,-,-,-,-,-,-,-,-,-,-,↓,↓,↑,↑,-,-,-,-,-,-,-,-,-,-,-,-,-,-,-,-,-,-,-,-,-,-,-,-,-,-,-,-,-,-,-,-,-,-,-,-,-,-,-,-,-,-,-,-,-,-,-,-,-,-,-,-,-,↓,↓,↑,↑,-,-,-,-
-,-,-,-,↓,↑,-,-,-,-,-,-,-,-,-,-,-,-,-,-,-,-,-,-,-,-,-,-,-,↓,↓,↑,↑,-,-,-,-,-,-,-,-,-,-,-,-,-,-,-,-,-,-,-,-,-,-,-,-,-,-,-,-,-,-,-,-,-,-,-,-,-,-,-,-,-,-,-,-,-,-,-,-,-,-,-,-,-,↓,↓,↑,↑,-,-,-,-
-,-,-,-,↓,↑,-,-,-,-,-,-,-,-,-,-,-,-,-,-,-,-,-,-,-,-,-,-,-,↓,↓,↑,↑,-,-,-,-,-,-,-,-,-,-,-,-,-,-,-,-,-,-,-,-,-,-,-,-,-,-,-,-,-,-,-,-,-,-,-,-,-,-,-,-,-,-,-,-,-,-,-,-,-,-,-,-,-,↓,↓,↑,↑,-,-,-,-
-,-,-,-,↓,↑,-,-,-,-,-,-,-,-,-,-,-,-,-,-,-,-,-,-,-,-,-,-,-,↓,↓,↑,↑,-,-,-,-,-,-,-,-,-,-,-,-,-,-,-,-,-,-,-,-,-,-,-,-,-,-,-,-,-,-,-,-,-,-,-,-,-,-,-,-,-,-,-,-,-,-,-,-,-,-,-,-,-,↓,↓,↑,↑,-,-,-,-
-,-,-,-,↓,↑,-,-,-,-,-,-,-,-,-,-,-,-,-,-,-,-,-,-,-,-,-,-,-,↓,↓,↑,↑,-,-,-,-,-,-,-,-,-,-,-,-,-,-,-,-,-,-,-,-,-,-,-,-,-,-,-,-,-,-,-,-,-,-,-,-,-,-,-,-,-,-,-,-,-,-,-,-,-,-,-,-,-,↓,↓,↑,↑,-,-,-,-
-,-,-,-,↓,↑,-,-,-,-,-,-,-,-,-,-,-,-,-,-,-,-,-,-,-,-,-,-,-,↓,↓,↑,↑,-,-,-,-,-,-,-,-,-,-,-,-,-,-,-,-,-,-,-,-,-,-,-,-,-,-,-,-,-,-,-,-,-,-,-,-,-,-,-,-,-,-,-,-,-,-,-,-,-,-,-,-,-,↓,↓,↑,↑,-,-,-,-
-,-,-,-,⇣,↑,-,-,-,-,-,-,-,-,-,-,-,-,-,-,-,-,-,-,-,-,-,-,-,⇣,⇣,↑,↑,-,-,-,-,-,-,-,-,-,-,-,-,-,-,-,-,-,-,-,-,-,-,-,-,-,-,-,-,-,-,-,-,-,-,-,-,-,-,-,-,-,-,-,-,-,-,-,-,-,-,-,-,-,↓,↓,↑,↑,-,-,-,-
-,←,←,←,+,+,←,←,←,←,←,←,←,←,←,←,←,←,←,←,←,←,←,←,←,←,←,←,←,+,+,+,+,⇠,←,←,←,←,←,←,←,←,←,←,←,←,←,←,←,←,←,←,←,←,←,←,←,←,←,←,←,←,←,←,←,←,←,←,←,←,←,←,←,←,←,←,←,←,←,←,←,←,←,←,←,←,+,+,+,+,⇠,←,←,-
-,←,←,←,+,+,←,←,←,←,←,←,←,←,←,←,←,←,←,←,←,←,←,←,←,←,←,←,←,+,+,+,+,⇠,←,←,←,←,←,←,←,←,←,←,←,←,←,←,←,←,←,←,←,←,←,←,←,←,←,←,←,←,←,←,←,←,←,←,←,←,←,←,←,←,←,←,←,←,←,←,←,←,←,←,←,←,+,+,+,+,⇠,←,←,-
-,→,→,⇢,+,+,→,→,→,→,→,→,→,→,→,→,→,→,→,→,→,→,→,→,→,→,→,→,⇢,+,+,+,+,→,→,→,→,→,→,→,→,→,→,→,→,→,→,→,→,→,→,→,→,→,→,→,→,→,→,→,→,→,→,→,→,→,→,→,→,→,→,→,→,→,→,→,→,→,→,→,→,→,→,→,→,→,+,+,+,+,→,→,→,-
-,→,→,⇢,+,+,→,→,→,→,→,→,→,→,→,→,→,→,→,→,→,→,→,→,→,→,→,→,⇢,+,+,+,+,→,→,→,→,→,→,→,→,→,→,→,→,→,→,→,→,→,→,→,→,→,→,→,→,→,→,→,→,→,→,→,→,→,→,→,→,→,→,→,→,→,→,→,→,→,→,→,→,→,→,→,→,→,+,+,+,+,→,→,→,-
-,-,-,-,↓,⇡,-,-,-,-,-,-,-,-,-,-,-,-,-,-,-,-,-,-,-,-,-,-,-,↓,↓,⇡,⇡,-,-,-,-,-,-,-,-,-,-,-,-,-,-,-,-,-,-,-,-,-,-,-,-,-,-,-,-,-,-,-,-,-,-,-,-,-,-,-,-,-,-,-,-,-,-,-,-,-,-,-,-,-,↓,↓,⇡,⇡,-,-,-,-
-,-,-,-,↓,↑,-,-,-,-,-,-,-,-,-,-,-,-,-,-,-,-,-,-,-,-,-,-,-,↓,↓,↑,↑,-,-,-,-,-,-,-,-,-,-,-,-,-,-,-,-,-,-,-,-,-,-,-,-,-,-,-,-,-,-,-,-,-,-,-,-,-,-,-,-,-,-,-,-,-,-,-,-,-,-,-,-,-,↓,↓,↑,↑,-,-,-,-
-,-,-,-,↓,↑,-,-,-,-,-,-,-,-,-,-,-,-,-,-,-,-,-,-,-,-,-,-,-,↓,↓,↑,↑,-,-,-,-,-,-,-,-,-,-,-,-,-,-,-,-,-,-,-,-,-,-,-,-,-,-,-,-,-,-,-,-,-,-,-,-,-,-,-,-,-,-,-,-,-,-,-,-,-,-,-,-,-,↓,↓,↑,↑,-,-,-,-
-,-,-,-,-,-,-,-,-,-,-,-,-,-,-,-,-,-,-,-,-,-,-,-,-,-,-,-,-,-,-,-,-,-,-,-,-,-,-,-,-,-,-,-,-,-,-,-,-,-,-,-,-,-,-,-,-,-,-,-,-,-,-,-,-,-,-,-,-,-,-,-,-,-,-,-,-,-,-,-,-,-,-,-,-,-,-,-,-,-,-,-,-,-
