-,-,-,-,-,-,-,-,-,-,-,-,-,-,-,-,-,-,-,-,-,-,-,-,-,-,-,-,-,-,-,-,-,-,-,-,-,-,-,-
-,↓,↓,↑,↑,-,-,-,-,-,-,-,-,-,-,-,-,-,-,-,-,-,-,-,-,-,-,-,-,-,-,-,-,-,-,-,-,-,-,-
-,↓,↓,↑,↑,-,-,-,-,-,-,-,-,-,-,-,-,-,-,-,-,-,-,-,-,-,-,-,-,-,-,-,-,-,-,-,-,-,-,-
-,↓,↓,↑,↑,-,-,-,-,-,-,-,-,-,-,-,-,-,-,-,-,-,-,-,-,-,-,-,-,-,-,-,-,-,-,-,-,-,-,-
-,⇣,⇣,↑,↑,-,-,-,-,-,-,-,-,-,-,-,-,-,-,-,-,-,-,-,-,-,-,-,-,-,-,-,-,-,-,-,-,-,-,-
-,+,+,+,+,⇠,←,←,←,←,←,←,←,←,←,←,←,←,+,+,+,+,-,-,-,-,-,-,-,-,-,-,-,-,-,-,-,-,-,-
-,+,+,+,+,⇠,←,←,←,←,←,←,←,←,←,←,←,←,+,+,+,+,-,-,-,-,-,-,-,-,-,-,-,-,-,-,-,-,-,-
-,+,+,+,+,→,→,→,→,→,→,→,→,→,→,→,→,⇢,+,+,+,+,-,-,-,-,-,↓,↓,↑,↑,-,-,-,-,-,-,-,-,-
-,+,+,+,+,→,→,→,→,→,→,→,→,→,→,→,→,⇢,+,+,+,+,-,-,-,-,-,↓,↓,↑,↑,-,-,-,-,-,-,-,-,-
-,↓,↓,⇡,⇡,-,-,-,-,-,-,-,-,-,-,-,-,-,↓,↓,⇡,⇡,-,-,-,-,-,↓,↓,↑,↑,-,-,-,-,-,-,-,-,-
-,↓,↓,↑,↑,-,-,-,-,-,-,-,-,-,-,-,-,-,↓,↓,↑,↑,-,-,-,-,-,↓,↓,↑,↑,-,-,-,-,-,-,-,-,-
-,↓,↓,↑,↑,-,-,-,-,-,-,-,-,-,-,-,-,-,⇣,⇣,↑,↑,-,-,-,-,-,⇣,⇣,↑,↑,-,-,-,-,-,-,-,-,-
-,↓,↓,↑,↑,-,-,-,-,+,+,+,+,⇠,←,←,←,←,+,+,+,+,⇠,←,←,←,←,+,+,+,+,⇠,←,←,←,←,←,←,←,-
-,↓,↓,↑,↑,-,-,-,-,+,+,+,+,⇠,←,←,←,←,+,+,+,+,⇠,←,←,←,←,+,+,+,+,⇠,←,←,←,←,←,←,←,-
-,↓,↓,↑,↑,-,-,-,-,+,+,+,+,→,→,→,→,⇢,+,+,+,+,→,→,→,→,⇢,+,+,+,+,→,→,→,→,→,→,→,→,-
-,↓,↓,↑,↑,-,-,-,-,+,+,+,+,→,→,→,→,⇢,+,+,+,+,→,→,→,→,⇢,+,+,+,+,→,→,→,→,→,→,→,→,-
-,↓,↓,↑,↑,-,-,-,-,↓,↓,⇡,⇡,-,-,-,-,-,↓,↓,⇡,⇡,-,-,-,-,-,↓,↓,⇡,⇡,-,-,-,-,-,-,-,-,-
-,↓,↓,↑,↑,-,-,-,-,↓,↓,↑,↑,-,-,-,-,-,↓,↓,↑,↑,-,-,-,-,-,↓,↓,↑,↑,-,-,-,-,-,-,-,-,-
-,↓,↓,↑,↑,-,-,-,-,↓,↓,↑,↑,-,-,-,-,-,↓,↓,↑,↑,-,-,-,-,-,↓,↓,↑,↑,-,-,-,-,-,-,-,-,-
-,↓,↓,↑,↑,-,-,-,-,↓,↓,↑,↑,-,-,-,-,-,↓,↓,↑,↑,-,-,-,-,-,↓,↓,↑,↑,-,-,-,-,-,-,-,-,-
-,⇣,⇣,↑,↑,-,-,-,-,⇣,⇣,↑,↑,-,-,-,-,-,⇣,⇣,↑,↑,-,-,-,-,-,⇣,⇣,↑,↑,-,-,-,-,-,-,-,-,-
-,+,+,+,+,⇠,←,←,←,+,+,+,+,⇠,←,←,←,←,+,+,+,+,⇠,←,←,←,←,+,+,+,+,⇠,←,←,←,+,+,+,+,-
-,+,+,+,+,⇠,←,←,←,+,+,+,+,⇠,←,←,←,←,+,+,+,+,⇠,←,←,←,←,+,+,+,+,⇠,←,←,←,+,+,+,+,-
-,+,+,+,+,→,→,→,⇢,+,+,+,+,→,→,→,→,⇢,+,+,+,+,→,→,→,→,⇢,+,+,+,+,→,→,→,⇢,+,+,+,+,-
-,+,+,+,+,→,→,→,⇢,+,+,+,+,→,→,→,→,⇢,+,+,+,+,→,→,→,→,⇢,+,+,+,+,→,→,→,⇢,+,+,+,+,-
-,-,-,-,-,-,-,-,-,-,-,-,-,-,-,-,-,-,↓,↓,⇡,⇡,-,-,-,-,-,↓,↓,⇡,⇡,-,-,-,-,↓,↓,⇡,⇡,-
-,-,-,-,-,-,-,-,-,-,-,-,-,-,-,-,-,-,↓,↓,↑,↑,-,-,-,-,-,↓,↓,↑,↑,-,-,-,-,↓,↓,↑,↑,-
-,-,-,-,-,-,-,-,-,-,-,-,-,-,-,-,-,-,↓,↓,↑,↑,-,-,-,-,-,↓,↓,↑,↑,-,-,-,-,↓,↓,↑,↑,-
-,-,-,-,-,-,-,-,-,-,-,-,-,-,-,-,-,-,↓,↓,↑,↑,-,-,-,-,-,↓,↓,↑,↑,-,-,-,-,↓,↓,↑,↑,-
-,-,-,-,-,-,-,-,-,-,-,-,-,-,-,-,-,-,↓,↓,↑,↑,-,-,-,-,-,↓,↓,↑,↑,-,-,-,-,↓,↓,↑,↑,-
-,-,-,-,-,-,-,-,-,-,-,-,-,-,-,-,-,-,⇣,⇣,↑,↑,-,-,-,-,-,⇣,⇣,↑,↑,-,-,-,-,↓,↓,↑,↑,-
-,-,-,-,-,-,-,-,-,-,-,←,←,←,←,←,←,←,+,+,+,+,⇠,←,←,←,←,+,+,+,+,-,-,-,-,↓,↓,↑,↑,-
-,-,-,-,-,-,-,-,-,-,-,←,←,←,←,←,←,←,+,+,+,+,⇠,←,←,←,←,+,+,+,+,-,-,-,-,↓,↓,↑,↑,-
-,-,-,-,-,-,-,-,-,-,-,→,→,→,→,→,→,⇢,+,+,+,+,→,→,→,→,⇢,+,+,+,+,-,-,-,-,↓,↓,↑,↑,-
-,-,-,-,-,-,-,-,-,-,-,→,→,→,→,→,→,⇢,+,+,+,+,→,→,→,→,⇢,+,+,+,+,-,-,-,-,↓,↓,↑,↑,-
-,-,-,-,-,-,-,-,-,-,-,-,-,-,-,-,-,-,↓,↓,⇡,⇡,-,-,-,-,-,-,-,-,-,-,-,-,-,↓,↓,↑,↑,-
-,-,-,-,-,-,-,-,-,-,-,-,-,-,-,-,-,-,↓,↓,↑,↑,-,-,-,-,-,-,-,-,-,-,-,-,-,↓,↓,↑,↑,-
-,-,-,-,-,-,-,-,-,-,-,-,-,-,-,-,-,-,⇣,⇣,↑,↑,-,-,-,-,-,-,-,-,-,-,-,-,-,⇣,⇣,↑,↑,-
-,-,-,-,-,-,-,-,-,-,-,-,-,-,-,-,-,-,+,+,+,+,⇠,←,←,←,←,←,←,←,←,←,←,←,←,+,+,+,+,-
-,-,-,-,-,-,-,-,-,-,-,-,-,-,-,-,-,-,+,+,+,+,⇠,←,←,←,←,←,←,←,←,←,←,←,←,+,+,+,+,-
-,-,-,-,-,-,-,-,-,-,-,-,-,-,-,-,-,-,+,+,+,+,→,→,→,→,→,→,→,→,→,→,→,→,⇢,+,+,+,+,-
-,-,-,-,-,-,-,-,-,-,-,-,-,-,-,-,-,-,+,+,+,+,→,→,→,→,→,→,→,→,→,→,→,→,⇢,+,+,+,+,-
-,-,-,-,-,-,-,-,-,-,-,-,-,-,-,-,-,-,-,-,-,-,-,-,-,-,-,-,-,-,-,-,-,-,-,↓,↓,⇡,⇡,-
-,-,-,-,-,-,-,-,-,-,-,-,-,-,-,-,-,-,-,-,-,-,-,-,-,-,-,-,-,-,-,-,-,-,-,↓,↓,↑,↑,-
-,-,-,-,-,-,-,-,-,-,-,-,-,-,-,-,-,-,-,-,-,-,-,-,-,-,-,-,-,-,-,-,-,-,-,↓,↓,↑,↑,-
-,-,-,-,-,-,-,-,-,-,-,-,-,-,-,-,-,-,-,-,-,-,-,-,-,-,-,-,-,-,-,-,-,-,-,↓,↓,↑,↑,-
-,-,-,-,-,-,-,-,-,-,-,-,-,-,-,-,-,-,-,-,-,-,-,-,-,-,-,-,-,-,-,-,-,-,-,-,-,-,-,-
