-,-,-,-,-,-,-,-,-,-,-,-,-,-,-,-,-,-,-,-,-,-,-,-,-,-,-,-,-,-,-,-,-,-,-,-,-,-,-,-,-,-,-,-,-,-,-,-,-,-,-,-,-,-,-,-,-,-,-,-,-,-,-,-,-,-,-,-,-,-,-,-,-,-,-,-,-,-,-,-,-,-,-,-,-,-,-,-,-,-,-,-,-,-
-,-,-,-,-,-,-,-,-,-,-,-,-,-,-,-,-,-,-,-,-,-,-,-,-,-,-,-,-,-,-,-,-,-,-,-,-,-,-,-,-,-,-,-,-,-,-,-,-,-,-,-,-,-,-,-,-,-,-,-,-,-,-,-,-,-,-,-,-,-,-,-,-,-,-,-,-,-,-,-,-,-,-,-,-,-,-,-,-,-,-,-,-,-
-,-,-,-,-,-,-,-,-,-,-,-,-,-,-,-,-,-,-,-,-,-,-,-,-,-,-,-,-,-,-,-,-,-,-,-,-,-,-,-,-,-,-,-,-,-,-,-,-,-,-,-,-,-,-,-,-,-,-,-,-,-,-,-,-,-,-,-,-,-,-,-,-,-,-,-,-,-,-,-,-,-,-,-,-,-,-,-,-,-,-,-,-,-
-,-,-,-,-,-,-,-,-,-,-,-,-,-,-,-,-,-,-,-,-,-,-,-,-,-,-,-,-,-,-,-,-,-,-,-,-,-,-,-,-,-,-,-,-,-,-,-,-,-,-,-,-,-,-,-,-,-,-,-,-,-,-,-,-,-,-,-,-,-,-,-,-,-,-,-,-,-,-,-,-,-,-,-,-,-,-,-,-,-,-,-,-,-
-,-,-,-,+,+,←,←,←,←,←,←,←,←,←,←,←,←,←,←,←,←,←,←,←,←,←,←,←,+,+,+,+,⇠,←,←,←,←,←,←,←,←,←,←,←,←,←,←,←,←,←,←,←,←,←,←,←,←,←,←,←,←,←,←,←,←,←,←,←,←,←,←,←,←,←,←,←,←,←,←,←,←,←,←,←,←,+,+,+,+,-,-,-,-
-,-,-,-,+,+,→,→,→,→,→,→,→,→,→,→,→,→,→,→,→,→,→,→,→,→,→,→,⇢,+,+,+,+,→,→,→,→,→,→,→,→,→,→,→,→,→,→,→,→,→,→,→,→,→,→,→,→,→,→,→,→,→,→,→,→,→,→,→,→,→,→,→,→,→,→,→,→,→,→,→,→,→,→,→,→,→,+,+,+,+,-,-,-,-
-,-,-,-,↓,↑,-,-,-,-,-,-,-,-,-,-,-,-,-,-,-,-,-,-,-,-,-,-,-,↓,↓,⇡,⇡,-,-,-,-,-,-,-,-,-,-,-,-,-,-,-,-,-,-,-,-,-,-,-,-,-,-,-,-,-,-,-,-,-,-,-,-,-,-,-,-,-,-,-,-,-,-,-,-,-,-,-,-,-,↓,↓,↑,↑,-,-,-,-
-,-,-,-,↓,↑,-,-,-,-,-,-,-,-,-,-,-,-,-,-,-,-,-,-,-,-,-,-,-,↓,↓,↑,↑,-,-,-,-,-,-,-,-,-,-,-,-,-,-,-,-,-,-,-,-,-,-,-,-,-,-,-,-,-,-,-,-,-,-,-,-,-,-,-,-,-,-,-,-,-,-,-,-,-,-,-,-,-,↓,↓,↑,↑,-,-,-,-
-,-,-,-,↓,↑,-,-,-,-,-,-,-,-,-,-,-,-,-,-,-,-,-,-,-,-,-,-,-,↓,↓,↑,↑,-,-,-,-,-,-,-,-,-,-,-,-,-,-,-,-,-,-,-,-,-,-,-,-,-,-,-,-,-,-,-,-,-,-,-,-,-,-,-,-,-,-,-,-,-,-,-,-,-,-,-,-,-,↓,↓,↑,↑,-,-,-,-
-,-,-,-,↓,↑,-,-,-,-,-,-,-,-,-,-,-,-,-,-,-,-,-,-,-,-,-,-,-,↓,↓,↑,↑,-,-,-,-,-,-,-,-,-,-,-,-,-,-,-,-,-,-,-,-,-,-,-,-,-,-,-,-,-,-,-,-,-,-,-,-,-,-,-,-,-,-,-,-,-,-,-,-,-,-,-,-,-,↓,↓,↑,↑,-,-,-,-
-,-,-,-,↓,↑,-,-,-,-,-,-,-,-,-,-,-,-,-,-,-,-,-,-,-,-,-,-,-,↓,↓,↑,↑,-,-,-,-,-,-,-,-,-,-,-,-,-,-,-,-,-,-,-,-,-,-,-,-,-,-,-,-,-,-,-,-,-,-,-,-,-,-,-,-,-,-,-,-,-,-,-,-,-,-,-,-,-,↓,↓,↑,↑,-,-,-,-
-,-,-,-,↓,↑,-,-,-,-,-,-,-,-,-,-,-,-,-,-,-,-,-,-,-,-,-,-,-,↓,↓,↑,↑,-,-,-,-,-,-,-,-,-,-,-,-,-,-,-,-,-,-,-,-,-,-,-,-,-,-,-,-,-,-,-,-,-,-,-,-,-,-,-,-,-,-,-,-,-,-,-,-,-,-,-,-,-,↓,↓,↑,↑,-,-,-,-
-,-,-,-,↓,↑,-,-,-,-,-,-,-,-,-,-,-,-,-,-,-,-,-,-,-,-,-,-,-,↓,↓,↑,↑,-,-,-,-,-,-,-,-,-,-,-,-,-,-,-,-,-,-,-,-,-,-,-,-,-,-,-,-,-,-,-,-,-,-,-,-,-,-,-,-,-,-,-,-,-,-,-,-,-,-,-,-,-,↓,↓,↑,↑,-,-,-,-
-,-,-,-,↓,↑,-,-,-,-,-,-,-,-,-,-,-,-,-,-,-,-,-,-,-,-,-,-,-,↓,↓,↑,↑,-,-,-,-,-,-,-,-,-,-,-,-,-,-,-,-,-,-,-,-,-,-,-,-,-,-,-,-,-,-,-,-,-,-,-,-,-,-,-,-,-,-,-,-,-,-,-,-,-,-,-,-,-,↓,↓,↑,↑,-,-,-,-
-,-,-,-,↓,↑,-,-,-,-,-,-,-,-,-,-,-,-,-,-,-,-,-,-,-,-,-,-,-,↓,↓,↑,↑,-,-,-,-,-,-,-,-,-,-,-,-,-,-,-,-,-,-,-,-,-,-,-,-,-,-,-,-,-,-,-,-,-,-,-,-,-,-,-,-,-,-,-,-,-,-,-,-,-,-,-,-,-,↓,↓,↑,↑,-,-,-,-
-,-,-,-,↓,↑,-,-,-,-,-,-,-,-,-,-,-,-,-,-,-,-,-,-,-,-,-,-,-,↓,↓,↑,↑,-,-,-,-,-,-,-,-,-,-,-,-,-,-,-,-,-,-,-,-,-,-,-,-,-,-,-,-,-,-,-,-,-,-,-,-,-,-,-,-,-,-,-,-,-,-,-,-,-,-,-,-,-,↓,↓,↑,↑,-,-,-,-
-,-,-,-,↓,↑,-,-,-,-,-,-,-,-,-,-,-,-,-,-,-,-,-,-,-,-,-,-,-,↓,↓,↑,↑,-,-,-,-,-,-,-,-,-,-,-,-,-,-,-,-,-,-,-,-,-,-,-,-,-,-,-,-,-,-,-,-,-,-,-,-,-,-,-,-,-,-,-,-,-,-,-,-,-,-,-,-,-,↓,↓,↑,↑,-,-,-,-
-,-,-,-,↓,↑,-,-,-,-,-,-,-,-,-,-,-,-,-,-,-,-,-,-,-,-,-,-,-,↓,↓,↑,↑,-,-,-,-,-,-,-,-,-,-,-,-,-,-,-,-,-,-,-,-,-,-,-,-,-,-,-,-,-,-,-,-,-,-,-,-,-,-,-,-,-,-,-,-,-,-,-,-,-,-,-,-,-,↓,↓,↑,↑,-,-,-,-
-,-,-,-,↓,↑,-,-,-,-,-,-,-,-,-,-,-,-,-,-,-,-,-,-,-,-,-,-,-,⇣,⇣,↑,↑,-,-,-,-,-,-,-,-,-,-,-,-,-,-,-,-,-,-,-,-,-,-,-,-,-,-,-,-,-,-,-,-,-,-,-,-,-,-,-,-,-,-,-,-,-,-,-,-,-,-,-,-,-,⇣,⇣,↑,↑,-,-,-,-
-,-,-,-,+,+,←,←,←,←,←,←,←,←,←,←,←,←,←,←,←,←,←,←,←,←,←,←,←,+,+,+,+,⇠,←,←,←,←,←,←,←,←,←,←,←,←,←,←,←,←,←,←,←,←,←,←,←,←,←,←,←,←,←,←,←,←,←,←,←,←,←,←,←,←,←,←,←,←,←,←,←,←,←,←,←,←,+,+,+,+,-,-,-,-
-,-,-,-,+,+,←,←,←,←,←,←,←,←,←,←,←,←,←,←,←,←,←,←,←,←,←,←,←,+,+,+,+,⇠,←,←,←,←,←,←,←,←,←,←,←,←,←,←,←,←,←,←,←,←,←,←,←,←,←,←,←,←,←,←,←,←,←,←,←,←,←,←,←,←,←,←,←,←,←,←,←,←,←,←,←,←,+,+,+,+,-,-,-,-
-,-,-,-,+,+,←,←,←,←,←,←,←,←,←,←,←,←,←,←,←,←,←,←,←,←,←,←,←,+,+,+,+,⇠,←,←,←,←,←,←,←,←,←,←,←,←,←,←,←,←,←,←,←,←,←,←,←,←,←,←,←,←,←,←,←,←,←,←,←,←,←,←,←,←,←,←,←,←,←,←,←,←,←,←,←,←,+,+,+,+,-,-,-,-
-,-,-,-,+,+,→,→,→,→,→,→,→,→,→,→,→,→,→,→,→,→,→,→,→,→,→,→,⇢,+,+,+,+,→,→,→,→,→,→,→,→,→,→,→,→,→,→,→,→,→,→,→,→,→,→,→,→,→,→,→,→,→,→,→,→,→,→,→,→,→,→,→,→,→,→,→,→,→,→,→,→,→,→,→,→,⇢,+,+,+,+,-,-,-,-
-,-,-,-,+,+,→,→,→,→,→,→,→,→,→,→,→,→,→,→,→,→,→,→,→,→,→,→,⇢,+,+,+,+,→,→,→,→,→,→,→,→,→,→,→,→,→,→,→,→,→,→,→,→,→,→,→,→,→,→,→,→,→,→,→,→,→,→,→,→,→,→,→,→,→,→,→,→,→,→,→,→,→,→,→,→,⇢,+,+,+,+,-,-,-,-
-,-,-,-,+,+,→,→,→,→,→,→,→,→,→,→,→,→,→,→,→,→,→,→,→,→,→,→,⇢,+,+,+,+,→,→,→,→,→,→,→,→,→,→,→,→,→,→,→,→,→,→,→,→,→,→,→,→,→,→,→,→,→,→,→,→,→,→,→,→,→,→,→,→,→,→,→,→,→,→,→,→,→,→,→,→,⇢,+,+,+,+,-,-,-,-
-,-,-,-,↓,↑,-,-,-,-,-,-,-,-,-,-,-,-,-,-,-,-,-,-,-,-,-,-,-,↓,↓,⇡,⇡,-,-,-,-,-,-,-,-,-,-,-,-,-,-,-,-,↓,↓,-,-,-,-,-,-,-,-,-,-,-,-,-,-,-,-,-,-,↑,↑,-,-,-,-,-,-,-,-,-,-,-,-,-,-,-,↓,↓,⇡,⇡,-,-,-,-
-,-,-,-,↓,↑,-,-,-,-,-,-,-,-,-,-,-,-,-,-,-,-,-,-,-,-,-,-,-,↓,↓,↑,↑,-,-,-,-,-,-,-,-,-,-,-,-,-,-,-,-,↓,↓,-,-,-,-,-,-,-,-,-,-,-,-,-,-,-,-,-,-,↑,↑,-,-,-,-,-,-,-,-,-,-,-,-,-,-,-,↓,↓,↑,↑,-,-,-,-
-,-,-,-,↓,↑,-,-,-,-,-,-,-,-,-,-,-,-,-,-,-,-,-,-,-,-,-,-,-,↓,↓,↑,↑,-,-,-,-,-,-,-,-,-,-,-,-,-,-,-,-,↓,↓,-,-,-,-,-,-,-,-,-,-,-,-,-,-,-,-,-,-,↑,↑,-,-,-,-,-,-,-,-,-,-,-,-,-,-,-,↓,↓,↑,↑,-,-,-,-
-,-,-,-,↓,↑,-,-,-,-,-,-,-,-,-,-,-,-,-,-,-,-,-,-,-,-,-,-,-,↓,↓,↑,↑,-,-,-,-,-,-,-,-,-,-,-,-,-,-,-,-,↓,↓,-,-,-,-,-,-,-,-,-,-,-,-,-,-,-,-,-,-,↑,↑,-,-,-,-,-,-,-,-,-,-,-,-,-,-,-,↓,↓,↑,↑,-,-,-,-
-,-,-,-,↓,↑,-,-,-,-,-,-,-,-,-,-,-,-,-,-,-,-,-,-,-,-,-,-,-,↓,↓,↑,↑,-,-,-,-,-,-,-,-,-,-,-,-,-,-,-,-,↓,↓,-,-,-,-,-,-,-,-,-,-,-,-,-,-,-,-,-,-,↑,↑,-,-,-,-,-,-,-,-,-,-,-,-,-,-,-,↓,↓,↑,↑,-,-,-,-
-,-,-,-,↓,↑,-,-,-,-,-,-,-,-,-,-,-,-,-,-,-,-,-,-,-,-,-,-,-,↓,↓,↑,↑,-,-,-,-,-,-,-,-,-,-,-,-,-,-,-,-,↓,↓,-,-,-,-,-,-,-,-,-,-,-,-,-,-,-,-,-,-,↑,↑,-,-,-,-,-,-,-,-,-,-,-,-,-,-,-,↓,↓,↑,↑,-,-,-,-
-,-,-,-,↓,↑,-,-,-,-,-,-,-,-,-,-,-,-,-,-,-,-,-,-,-,-,-,-,-,↓,↓,↑,↑,-,-,-,-,-,-,-,-,-,-,-,-,-,-,-,-,↓,↓,-,-,-,-,-,-,-,-,-,-,-,-,-,-,-,-,-,-,↑,↑,-,-,-,-,-,-,-,-,-,-,-,-,-,-,-,↓,↓,↑,↑,-,-,-,-
-,-,-,-,↓,↑,-,-,-,-,-,-,-,-,-,-,-,-,-,-,-,-,-,-,-,-,-,-,-,↓,↓,↑,↑,-,-,-,-,-,-,-,-,-,-,-,-,-,-,-,-,↓,↓,-,-,-,-,-,-,-,-,-,-,-,-,-,-,-,-,-,-,↑,↑,-,-,-,-,-,-,-,-,-,-,-,-,-,-,-,↓,↓,↑,↑,-,-,-,-
-,-,-,-,↓,↑,-,-,-,-,-,-,-,-,-,-,-,-,-,-,-,-,-,-,-,-,-,-,-,↓,↓,↑,↑,-,-,-,-,-,-,-,-,-,-,-,-,-,-,-,-,↓,↓,-,-,-,-,-,-,-,-,-,-,-,-,-,-,-,-,-,-,↑,↑,-,-,-,-,-,-,-,-,-,-,-,-,-,-,-,↓,↓,↑,↑,-,-,-,-
-,-,-,-,↓,↑,-,-,-,-,-,-,-,-,-,-,-,-,-,-,-,-,-,-,-,-,-,-,-,↓,↓,↑,↑,-,-,-,-,-,-,-,-,-,-,-,-,-,-,-,-,↓,↓,-,-,-,-,-,-,-,-,-,-,-,-,-,-,-,-,-,-,↑,↑,-,-,-,-,-,-,-,-,-,-,-,-,-,-,-,↓,↓,↑,↑,-,-,-,-
-,-,-,-,↓,↑,-,-,-,-,-,-,-,-,-,-,-,-,-,-,-,-,-,-,-,-,-,-,-,↓,↓,↑,↑,-,-,-,-,-,-,-,-,-,-,-,-,-,-,-,-,↓,↓,-,-,-,-,-,-,-,-,-,-,-,-,-,-,-,-,-,-,↑,↑,-,-,-,-,-,-,-,-,-,-,-,-,-,-,-,↓,↓,↑,↑,-,-,-,-
-,-,-,-,↓,↑,-,-,-,-,-,-,-,-,-,-,-,-,-,-,-,-,-,-,-,-,-,-,-,↓,↓,↑,↑,-,-,-,-,-,-,-,-,-,-,-,-,-,-,-,-,↓,↓,-,-,-,-,-,-,-,-,-,-,-,-,-,-,-,-,-,-,↑,↑,-,-,-,-,-,-,-,-,-,-,-,-,-,-,-,↓,↓,↑,↑,-,-,-,-
-,-,-,-,↓,↑,-,-,-,-,-,-,-,-,-,-,-,-,-,-,-,-,-,-,-,-,-,-,-,↓,↓,↑,↑,-,-,-,-,-,-,-,-,-,-,-,-,-,-,-,-,↓,↓,-,-,-,-,-,-,-,-,-,-,-,-,-,-,-,-,-,-,↑,↑,-,-,-,-,-,-,-,-,-,-,-,-,-,-,-,↓,↓,↑,↑,-,-,-,-
-,-,-,-,↓,↑,-,-,-,-,-,-,-,-,-,-,-,-,-,-,-,-,-,-,-,-,-,-,-,↓,↓,↑,↑,-,-,-,-,-,-,-,-,-,-,-,-,-,-,-,-,↓,↓,-,-,-,-,-,-,-,-,-,-,-,-,-,-,-,-,-,-,↑,↑,-,-,-,-,-,-,-,-,-,-,-,-,-,-,-,↓,↓,↑,↑,-,-,-,-
-,-,-,-,↓,↑,-,-,-,-,-,-,-,-,-,-,-,-,-,-,-,-,-,-,-,-,-,-,-,↓,↓,↑,↑,-,-,-,-,-,-,-,-,-,-,-,-,-,-,-,-,↓,↓,-,-,-,-,-,-,-,-,-,-,-,-,-,-,-,-,-,-,↑,↑,-,-,-,-,-,-,-,-,-,-,-,-,-,-,-,↓,↓,↑,↑,-,-,-,-
-,-,-,-,↓,↑,-,-,-,-,-,-,-,-,-,-,-,-,-,-,-,-,-,-,-,-,-,-,-,↓,↓,↑,↑,-,-,-,-,-,-,-,-,-,-,-,-,-,-,-,-,↓,↓,→,→,→,→,→,→,→,→,→,→,→,→,→,→,→,→,→,→,↑,↑,-,-,-,-,-,-,-,-,-,-,-,-,-,-,-,↓,↓,↑,↑,-,-,-,-
-,-,-,-,↓,↑,-,-,-,-,-,-,-,-,-,-,-,-,-,-,-,-,-,-,-,-,-,-,-,↓,↓,↑,↑,-,-,-,-,-,-,-,-,-,-,-,-,-,-,-,-,-,→,→,→,→,→,→,→,→,→,→,→,→,→,→,→,→,→,→,→,→,-,-,-,-,-,-,-,-,-,-,-,-,-,-,-,-,↓,↓,↑,↑,-,-,-,-
-,-,-,-,↓,↑,-,-,-,-,-,-,-,-,-,-,-,-,-,-,-,-,-,-,-,-,-,-,-,↓,↓,↑,↑,-,-,-,-,-,-,-,-,-,-,-,-,-,-,-,-,-,-,-,-,-,-,-,-,-,-,-,-,-,-,-,-,-,-,-,-,-,-,-,-,-,-,-,-,-,-,-,-,-,-,-,-,-,↓,↓,↑,↑,-,-,-,-
-,-,-,-,↓,↑,-,-,-,-,-,-,-,-,-,-,-,-,-,-,-,-,-,-,-,-,-,-,-,↓,↓,↑,↑,-,-,-,-,-,-,-,-,-,-,-,-,-,-,-,-,-,-,-,-,-,-,-,-,-,-,-,-,-,-,-,-,-,-,-,-,-,-,-,-,-,-,-,-,-,-,-,-,-,-,-,-,-,↓,↓,↑,↑,-,-,-,-
-,-,-,-,↓,↑,-,-,-,-,-,-,-,-,-,-,-,-,-,-,-,-,-,-,-,-,-,-,-,↓,↓,↑,↑,-,-,-,-,-,-,-,-,-,-,-,-,-,-,-,-,-,-,-,-,-,-,-,-,-,-,-,-,-,-,-,-,-,-,-,-,-,-,-,-,-,-,-,-,-,-,-,-,-,-,-,-,-,↓,↓,↑,↑,-,-,-,-
-,-,-,-,↓,↑,-,-,-,-,-,-,-,-,-,-,-,-,-,-,-,-,-,-,-,-,-,-,-,↓,↓,↑,↑,-,-,-,-,-,-,-,-,-,-,-,-,-,-,-,-,-,-,-,-,-,-,-,-,-,-,-,-,-,-,-,-,-,-,-,-,-,-,-,-,-,-,-,-,-,-,-,-,-,-,-,-,-,↓,↓,↑,↑,-,-,-,-
-,-,-,-,↓,↑,-,-,-,-,-,-,-,-,-,-,-,-,-,-,-,-,-,-,-,-,-,-,-,↓,↓,↑,↑,-,-,-,-,-,-,-,-,-,-,-,-,-,-,-,-,-,-,-,-,-,-,-,-,-,-,-,-,-,-,-,-,-,-,-,-,-,-,-,-,-,-,-,-,-,-,-,-,-,-,-,-,-,↓,↓,↑,↑,-,-,-,-
-,-,-,-,↓,↑,-,-,-,-,-,-,-,-,-,-,-,-,-,-,-,-,-,-,-,-,-,-,-,↓,↓,↑,↑,-,-,-,-,-,-,-,-,-,-,-,-,-,-,-,-,-,-,-,-,-,-,-,-,-,-,-,-,-,-,-,-,-,-,-,-,-,-,-,-,-,-,-,-,-,-,-,-,-,-,-,-,-,↓,↓,↑,↑,-,-,-,-
-,-,-,-,↓,↑,-,-,-,-,-,-,-,-,-,-,-,-,-,-,-,-,-,-,-,-,-,-,-,↓,↓,↑,↑,-,-,-,-,-,-,-,-,-,-,-,-,-,-,-,-,-,-,-,-,-,-,-,-,-,-,-,-,-,-,-,-,-,-,-,-,-,-,-,-,-,-,-,-,-,-,-,-,-,-,-,-,-,↓,↓,↑,↑,-,-,-,-
-,-,-,-,↓,↑,-,-,-,-,-,-,-,-,-,-,-,-,-,-,-,-,-,-,-,-,-,-,-,⇣,⇣,↑,↑,-,-,-,-,-,-,-,-,-,-,-,-,-,-,-,-,-,-,-,-,-,-,-,-,-,-,-,-,-,-,-,-,-,-,-,-,-,-,-,-,-,-,-,-,-,-,-,-,-,-,-,-,-,↓,↓,↑,↑,-,-,-,-
-,-,-,-,+,+,←,←,←,←,←,←,←,←,←,←,←,←,←,←,←,←,←,←,←,←,←,←,←,+,+,+,+,⇠,←,←,←,←,←,←,←,←,←,←,←,←,←,←,←,←,←,←,←,←,←,←,←,←,←,←,←,←,←,←,←,←,←,←,←,←,←,←,←,←,←,←,←,←,←,←,←,←,←,←,←,←,+,+,+,+,-,-,-,-
-,-,-,-,+,+,←,←,←,←,←,←,←,←,←,←,←,←,←,←,←,←,←,←,←,←,←,←,←,+,+,+,+,⇠,←,←,←,←,←,←,←,←,←,←,←,←,←,←,←,←,←,←,←,←,←,←,←,←,←,←,←,←,←,←,←,←,←,←,←,←,←,←,←,←,←,←,←,←,←,←,←,←,←,←,←,←,+,+,+,+,-,-,-,-
-,-,-,-,+,+,→,→,→,→,→,→,→,→,→,→,→,→,→,→,→,→,→,→,→,→,→,→,⇢,+,+,+,+,→,→,→,→,→,→,→,→,→,→,→,→,→,→,→,→,→,→,→,→,→,→,→,→,→,→,→,→,→,→,→,→,→,→,→,→,→,→,→,→,→,→,→,→,→,→,→,→,→,→,→,→,→,+,+,+,+,-,-,-,-
-,-,-,-,+,+,→,→,→,→,→,→,→,→,→,→,→,→,→,→,→,→,→,→,→,→,→,→,⇢,+,+,+,+,→,→,→,→,→,→,→,→,→,→,→,→,→,→,→,→,→,→,→,→,→,→,→,→,→,→,→,→,→,→,→,→,→,→,→,→,→,→,→,→,→,→,→,→,→,→,→,→,→,→,→,→,→,+,+,+,+,-,-,-,-
-,-,-,-,-,-,-,-,-,-,-,-,-,-,-,-,-,-,-,-,-,-,-,-,-,-,-,-,-,-,-,-,-,-,-,-,-,-,-,-,-,-,-,-,-,-,-,-,-,-,-,-,-,-,-,-,-,-,-,-,-,-,-,-,-,-,-,-,-,-,-,-,-,-,-,-,-,-,-,-,-,-,-,-,-,-,-,-,-,-,-,-,-,-
-,-,-,-,-,-,-,-,-,-,-,-,-,-,-,-,-,-,-,-,-,-,-,-,-,-,-,-,-,-,-,-,-,-,-,-,-,-,-,-,-,-,-,-,-,-,-,-,-,-,-,-,-,-,-,-,-,-,-,-,-,-,-,-,-,-,-,-,-,-,-,-,-,-,-,-,-,-,-,-,-,-,-,-,-,-,-,-,-,-,-,-,-,-
-,-,-,-,-,-,-,-,-,-,-,-,-,-,-,-,-,-,-,-,-,-,-,-,-,-,-,-,-,-,-,-,-,-,-,-,-,-,-,-,-,-,-,-,-,-,-,-,-,-,-,-,-,-,-,-,-,-,-,-,-,-,-,-,-,-,-,-,-,-,-,-,-,-,-,-,-,-,-,-,-,-,-,-,-,-,-,-,-,-,-,-,-,-
-,-,-,-,-,-,-,-,-,-,-,-,-,-,-,-,-,-,-,-,-,-,-,-,-,-,-,-,-,-,-,-,-,-,-,-,-,-,-,-,-,-,-,-,-,-,-,-,-,-,-,-,-,-,-,-,-,-,-,-,-,-,-,-,-,-,-,-,-,-,-,-,-,-,-,-,-,-,-,-,-,-,-,-,-,-,-,-,-,-,-,-,-,-
