-,-,-,-,-,-,-,-,-,-,-,-,-,-,-,-,-,-,-,-,-,-,-,-,-,-,-,-,-,-,-,-,-,-,-,-,-,-,-,-,-,-,-,-,-,-,-,-,-,-,-,-,-,-,-,-,-,-,-,-,-
-,-,-,-,-,-,-,-,-,-,-,-,-,-,-,↓,↓,↑,↑,-,-,-,-,-,-,-,-,-,-,-,-,-,-,-,-,-,-,-,-,-,-,↓,↓,↑,↑,-,-,-,-,-,-,-,-,-,-,-,-,-,-,-,-
-,-,-,-,-,-,-,-,-,-,-,-,-,-,-,↓,↓,↑,↑,-,-,-,-,-,-,-,-,-,-,-,-,-,-,-,-,-,-,-,-,-,-,↓,↓,↑,↑,-,-,-,-,-,-,-,-,-,-,-,-,-,-,-,-
-,-,-,-,-,-,-,-,-,-,-,-,-,-,-,↓,↓,↑,↑,-,-,-,-,-,-,-,-,-,-,-,-,-,-,-,-,-,-,-,-,-,-,↓,↓,↑,↑,-,-,-,-,-,-,-,-,-,-,-,-,-,-,-,-
-,-,-,-,-,-,-,-,-,-,-,-,-,-,-,↓,↓,↑,↑,-,-,-,-,-,-,-,-,-,-,-,-,-,-,-,-,-,-,-,-,-,-,↓,↓,↑,↑,-,-,-,-,-,-,-,-,-,-,-,-,-,-,-,-
-,-,-,-,-,-,-,-,-,-,-,-,-,-,-,↓,↓,↑,↑,-,-,-,-,-,-,-,-,-,-,-,-,-,-,-,-,-,-,-,-,-,-,↓,↓,↑,↑,-,-,-,-,-,-,-,-,-,-,-,-,-,-,-,-
-,-,-,-,-,-,-,-,-,-,-,-,-,-,-,↓,↓,↑,↑,-,-,-,-,-,-,-,-,-,-,-,-,-,-,-,-,-,-,-,-,-,-,↓,↓,↑,↑,-,-,-,-,-,-,-,-,-,-,-,-,-,-,-,-
-,-,-,-,-,-,-,-,-,-,-,-,-,-,-,↓,↓,↑,↑,-,-,-,-,-,-,-,-,-,-,-,-,-,-,-,-,-,-,-,-,-,-,↓,↓,↑,↑,-,-,-,-,-,-,-,-,-,-,-,-,-,-,-,-
-,-,-,-,-,-,-,-,-,-,-,-,-,-,-,↓,↓,↑,↑,-,-,-,-,-,-,-,-,-,-,-,-,-,-,-,-,-,-,-,-,-,-,↓,↓,↑,↑,-,-,-,-,-,-,-,-,-,-,-,-,-,-,-,-
-,-,-,-,-,-,-,-,-,-,-,-,-,-,-,↓,↓,↑,↑,-,-,-,-,-,-,-,-,-,-,-,-,-,-,-,-,-,-,-,-,-,-,↓,↓,↑,↑,-,-,-,-,-,-,-,-,-,-,-,-,-,-,-,-
-,-,-,-,-,-,-,-,-,-,-,-,-,-,-,↓,↓,↑,↑,-,-,-,-,-,-,-,-,-,-,-,-,-,-,-,-,-,-,-,-,-,-,↓,↓,↑,↑,-,-,-,-,-,-,-,-,-,-,-,-,-,-,-,-
-,-,-,-,-,-,-,-,-,-,-,-,-,-,-,↓,↓,↑,↑,-,-,-,-,-,-,-,-,-,-,-,-,-,-,-,-,-,-,-,-,-,-,↓,↓,↑,↑,-,-,-,-,-,-,-,-,-,-,-,-,-,-,-,-
-,-,-,-,-,-,-,-,-,-,-,-,-,-,-,↓,↓,↑,↑,-,-,-,-,-,-,-,-,-,-,-,-,-,-,-,-,-,-,-,-,-,-,↓,↓,↑,↑,-,-,-,-,-,-,-,-,-,-,-,-,-,-,-,-
-,-,-,-,-,-,-,-,-,-,-,-,-,-,-,↓,↓,↑,↑,-,-,-,-,-,-,-,-,-,-,-,-,-,-,-,-,-,-,-,-,-,-,↓,↓,↑,↑,-,-,-,-,-,-,-,-,-,-,-,-,-,-,-,-
-,-,-,-,-,-,-,-,-,-,-,-,-,-,-,⇣,⇣,↑,↑,-,-,-,-,-,-,-,-,-,-,-,-,-,-,-,-,-,-,-,-,-,-,⇣,⇣,↑,↑,-,-,-,-,-,-,-,-,-,-,-,-,-,-,-,-
-,←,←,←,←,←,←,←,←,←,←,←,←,←,←,+,+,+,+,⇠,←,←,←,←,←,←,←,←,←,←,←,←,←,←,←,←,←,←,←,←,←,+,+,+,+,⇠,←,←,←,←,←,←,←,←,←,←,←,←,←,←,-
-,←,←,←,←,←,←,←,←,←,←,←,←,←,←,+,+,+,+,⇠,←,←,←,←,←,←,←,←,←,←,←,←,←,←,←,←,←,←,←,←,←,+,+,+,+,⇠,←,←,←,←,←,←,←,←,←,←,←,←,←,←,-
-,→,→,→,→,→,→,→,→,→,→,→,→,→,⇢,+,+,+,+,→,→,→,→,→,→,→,→,→,→,→,→,→,→,→,→,→,→,→,→,→,⇢,+,+,+,+,→,→,→,→,→,→,→,→,→,→,→,→,→,→,→,-
-,→,→,→,→,→,→,→,→,→,→,→,→,→,⇢,+,+,+,+,→,→,→,→,→,→,→,→,→,→,→,→,→,→,→,→,→,→,→,→,→,⇢,+,+,+,+,→,→,→,→,→,→,→,→,→,→,→,→,→,→,→,-
-,-,-,-,-,-,-,-,-,-,-,-,-,-,-,↓,↓,⇡,⇡,-,-,-,-,-,-,-,-,-,-,-,-,-,-,-,-,-,-,-,-,-,-,↓,↓,⇡,⇡,-,-,-,-,-,-,-,-,-,-,-,-,-,-,-,-
-,-,-,-,-,-,-,-,-,-,-,-,-,-,-,↓,↓,↑,↑,-,-,-,-,-,-,-,-,-,-,-,-,-,-,-,-,-,-,-,-,-,-,↓,↓,↑,↑,-,-,-,-,-,-,-,-,-,-,-,-,-,-,-,-
-,-,-,-,-,-,-,-,-,-,-,-,-,-,-,↓,↓,↑,↑,-,-,-,-,-,-,-,-,-,-,-,-,-,-,-,-,-,-,-,-,-,-,↓,↓,↑,↑,-,-,-,-,-,-,-,-,-,-,-,-,-,-,-,-
-,-,-,-,-,-,-,-,-,-,-,-,-,-,-,↓,↓,↑,↑,-,-,-,-,-,-,-,-,-,-,-,-,-,-,-,-,-,-,-,-,-,-,↓,↓,↑,↑,-,-,-,-,-,-,-,-,-,-,-,-,-,-,-,-
-,-,-,-,-,-,-,-,-,-,-,-,-,-,-,↓,↓,↑,↑,-,-,-,-,-,-,-,-,-,-,-,-,-,-,-,-,-,-,-,-,-,-,↓,↓,↑,↑,-,-,-,-,-,-,-,-,-,-,-,-,-,-,-,-
-,-,-,-,-,-,-,-,-,-,-,-,-,-,-,↓,↓,↑,↑,-,-,-,-,-,-,-,-,-,-,-,-,-,-,-,-,-,-,-,-,-,-,↓,↓,↑,↑,-,-,-,-,-,-,-,-,-,-,-,-,-,-,-,-
-,-,-,-,-,-,-,-,-,-,-,-,-,-,-,↓,↓,↑,↑,-,-,-,-,-,-,-,-,-,-,-,-,-,-,-,-,-,-,-,-,-,-,↓,↓,↑,↑,-,-,-,-,-,-,-,-,-,-,-,-,-,-,-,-
-,-,-,-,-,-,-,-,-,-,-,-,-,-,-,↓,↓,↑,↑,-,-,-,-,-,-,-,-,-,-,-,-,-,-,-,-,-,-,-,-,-,-,↓,↓,↑,↑,-,-,-,-,-,-,-,-,-,-,-,-,-,-,-,-
-,-,-,-,-,-,-,-,-,-,-,-,-,-,-,↓,↓,↑,↑,-,-,-,-,-,-,-,-,-,-,-,-,-,-,-,-,-,-,-,-,-,-,↓,↓,↑,↑,-,-,-,-,-,-,-,-,-,-,-,-,-,-,-,-
-,-,-,-,-,-,-,-,-,-,-,-,-,-,-,↓,↓,↑,↑,-,-,-,-,-,-,-,-,-,-,-,-,-,-,-,-,-,-,-,-,-,-,↓,↓,↑,↑,-,-,-,-,-,-,-,-,-,-,-,-,-,-,-,-
-,-,-,-,-,-,-,-,-,-,-,-,-,-,-,↓,↓,↑,↑,-,-,-,-,-,-,-,-,-,-,-,-,-,-,-,-,-,-,-,-,-,-,↓,↓,↑,↑,-,-,-,-,-,-,-,-,-,-,-,-,-,-,-,-
-,-,-,-,-,-,-,-,-,-,-,-,-,-,-,⇣,⇣,↑,↑,-,-,-,-,-,-,-,-,-,-,-,-,-,-,-,-,-,-,-,-,-,-,⇣,⇣,↑,↑,-,-,-,-,-,-,-,-,-,-,-,-,-,-,-,-
-,←,←,←,←,←,←,←,←,←,←,←,←,←,←,+,+,+,+,⇠,←,←,←,←,←,←,←,←,←,←,←,←,←,←,←,←,←,←,←,←,←,+,+,+,+,⇠,←,←,←,←,←,←,←,←,←,←,←,←,←,←,-
-,←,←,←,←,←,←,←,←,←,←,←,←,←,←,+,+,+,+,⇠,←,←,←,←,←,←,←,←,←,←,←,←,←,←,←,←,←,←,←,←,←,+,+,+,+,⇠,←,←,←,←,←,←,←,←,←,←,←,←,←,←,-
-,→,→,→,→,→,→,→,→,→,→,→,→,→,⇢,+,+,+,+,→,→,→,→,→,→,→,→,→,→,→,→,→,→,→,→,→,→,→,→,→,⇢,+,+,+,+,→,→,→,→,→,→,→,→,→,→,→,→,→,→,→,-
-,→,→,→,→,→,→,→,→,→,→,→,→,→,⇢,+,+,+,+,→,→,→,→,→,→,→,→,→,→,→,→,→,→,→,→,→,→,→,→,→,⇢,+,+,+,+,→,→,→,→,→,→,→,→,→,→,→,→,→,→,→,-
-,-,-,-,-,-,-,-,-,-,-,-,-,-,-,↓,↓,⇡,⇡,-,-,-,-,-,-,-,-,-,-,-,-,-,-,-,-,-,-,-,-,-,-,↓,↓,⇡,⇡,-,-,-,-,-,-,-,-,-,-,-,-,-,-,-,-
-,-,-,-,-,-,-,-,-,-,-,-,-,-,-,↓,↓,↑,↑,-,-,-,-,-,-,-,-,-,-,-,-,-,-,-,-,-,-,-,-,-,-,↓,↓,↑,↑,-,-,-,-,-,-,-,-,-,-,-,-,-,-,-,-
-,-,-,-,-,-,-,-,-,-,-,-,-,-,-,↓,↓,↑,↑,-,-,-,-,-,-,-,-,-,-,-,-,-,-,-,-,-,-,-,-,-,-,↓,↓,↑,↑,-,-,-,-,-,-,-,-,-,-,-,-,-,-,-,-
-,-,-,-,-,-,-,-,-,-,-,-,-,-,-,↓,↓,↑,↑,-,-,-,-,-,-,-,-,-,-,-,-,-,-,-,-,-,-,-,-,-,-,↓,↓,↑,↑,-,-,-,-,-,-,-,-,-,-,-,-,-,-,-,-
-,-,-,-,-,-,-,-,-,-,-,-,-,-,-,↓,↓,↑,↑,-,-,-,-,-,-,-,-,-,-,-,-,-,-,-,-,-,-,-,-,-,-,↓,↓,↑,↑,-,-,-,-,-,-,-,-,-,-,-,-,-,-,-,-
-,-,-,-,-,-,-,-,-,-,-,-,-,-,-,↓,↓,↑,↑,-,-,-,-,-,-,-,-,-,-,-,-,-,-,-,-,-,-,-,-,-,-,↓,↓,↑,↑,-,-,-,-,-,-,-,-,-,-,-,-,-,-,-,-
-,-,-,-,-,-,-,-,-,-,-,-,-,-,-,↓,↓,↑,↑,-,-,-,-,-,-,-,-,-,-,-,-,-,-,-,-,-,-,-,-,-,-,↓,↓,↑,↑,-,-,-,-,-,-,-,-,-,-,-,-,-,-,-,-
-,-,-,-,-,-,-,-,-,-,-,-,-,-,-,↓,↓,↑,↑,-,-,-,-,-,-,-,-,-,-,-,-,-,-,-,-,-,-,-,-,-,-,↓,↓,↑,↑,-,-,-,-,-,-,-,-,-,-,-,-,-,-,-,-
-,-,-,-,-,-,-,-,-,-,-,-,-,-,-,↓,↓,↑,↑,-,-,-,-,-,-,-,-,-,-,-,-,-,-,-,-,-,-,-,-,-,-,↓,↓,↑,↑,-,-,-,-,-,-,-,-,-,-,-,-,-,-,-,-
-,-,-,-,-,-,-,-,-,-,-,-,-,-,-,↓,↓,↑,↑,-,-,-,-,-,-,-,-,-,-,-,-,-,-,-,-,-,-,-,-,-,-,↓,↓,↑,↑,-,-,-,-,-,-,-,-,-,-,-,-,-,-,-,-
-,-,-,-,-,-,-,-,-,-,-,-,-,-,-,↓,↓,↑,↑,-,-,-,-,-,-,-,-,-,-,-,-,-,-,-,-,-,-,-,-,-,-,↓,↓,↑,↑,-,-,-,-,-,-,-,-,-,-,-,-,-,-,-,-
-,-,-,-,-,-,-,-,-,-,-,-,-,-,-,↓,↓,↑,↑,-,-,-,-,-,-,-,-,-,-,-,-,-,-,-,-,-,-,-,-,-,-,↓,↓,↑,↑,-,-,-,-,-,-,-,-,-,-,-,-,-,-,-,-
-,-,-,-,-,-,-,-,-,-,-,-,-,-,-,↓,↓,↑,↑,-,-,-,-,-,-,-,-,-,-,-,-,-,-,-,-,-,-,-,-,-,-,↓,↓,↑,↑,-,-,-,-,-,-,-,-,-,-,-,-,-,-,-,-
-,-,-,-,-,-,-,-,-,-,-,-,-,-,-,↓,↓,↑,↑,-,-,-,-,-,-,-,-,-,-,-,-,-,-,-,-,-,-,-,-,-,-,↓,↓,↑,↑,-,-,-,-,-,-,-,-,-,-,-,-,-,-,-,-
-,-,-,-,-,-,-,-,-,-,-,-,-,-,-,-,-,-,-,-,-,-,-,-,-,-,-,-,-,-,-,-,-,-,-,-,-,-,-,-,-,-,-,-,-,-,-,-,-,-,-,-,-,-,-,-,-,-,-,-,-
